Rk,Player,Pos,Age,Tm,G,GS,MP,FG,FGA,FG%,3P,3PA,3P%,2P,2PA,2P%,eFG%,FT,FTA,FT%,ORB,DRB,TRB,AST,STL,BLK,TOV,PF,PTS
1,Precious Achiuwa\achiupr01,C,22,TOR,66,27,1564,238,544,.438,45,126,.357,193,418,.462,.479,68,115,.591,140,311,451,75,33,38,74,140,589
2,Steven Adams\adamsst01,C,28,MEM,72,71,1894,203,372,.546,0,1,.000,203,371,.547,.546,105,191,.550,337,383,720,237,62,58,107,140,511
3,Bam Adebayo\adebaba01,C,24,MIA,51,51,1666,373,674,.553,0,6,.000,373,668,.558,.553,227,301,.754,128,393,521,171,75,43,139,158,973
4,Santi Aldama\aldamsa01,PF,21,MEM,29,0,298,38,101,.376,4,41,.098,34,60,.567,.396,12,20,.600,24,43,67,15,2,9,11,29,92
5,LaMarcus Aldridge\aldrila01,C,36,BRK,45,12,1027,252,455,.554,14,45,.311,238,410,.580,.569,89,102,.873,71,181,252,41,14,46,42,74,607
6,Nickeil Alexander-Walker\alexani01,SG,23,TOT,62,21,1444,249,672,.371,102,331,.308,147,341,.431,.446,80,108,.741,37,147,184,152,44,23,92,101,680
6,Nickeil Alexander-Walker\alexani01,SG,23,NOP,50,19,1317,237,632,.375,95,305,.311,142,327,.434,.450,70,97,.722,36,128,164,139,41,19,85,88,639
6,Nickeil Alexander-Walker\alexani01,SG,23,UTA,12,2,127,12,40,.300,7,26,.269,5,14,.357,.388,10,11,.909,1,19,20,13,3,4,7,13,41
7,Grayson Allen\allengr01,SG,26,MIL,62,61,1704,243,548,.443,153,375,.408,90,173,.520,.583,58,67,.866,29,179,208,96,44,16,40,91,697
8,Jarrett Allen\allenja01,C,23,CLE,56,56,1809,369,545,.677,1,10,.100,368,535,.688,.678,165,233,.708,192,410,602,92,44,75,94,97,904
9,Jose Alvarado\alvarjo01,PG,23,NOP,47,1,721,112,257,.436,31,99,.313,81,158,.513,.496,32,44,.727,22,64,86,128,59,7,33,69,287
10,Justin Anderson\anderju01,SF,28,TOT,12,5,248,28,70,.400,13,45,.289,15,25,.600,.493,14,18,.778,4,37,41,27,5,3,8,17,83
10,Justin Anderson\anderju01,SF,28,CLE,3,0,47,4,8,.500,2,6,.333,2,2,1.000,.625,3,4,.750,0,6,6,6,1,0,2,4,13
10,Justin Anderson\anderju01,SF,28,IND,9,5,201,24,62,.387,11,39,.282,13,23,.565,.476,11,14,.786,4,31,35,21,4,3,6,13,70
11,Kyle Anderson\anderky01,PF,28,MEM,63,9,1347,188,429,.438,32,99,.323,156,330,.473,.476,61,97,.629,64,273,337,161,69,41,60,95,469
12,Giannis Antetokounmpo\antetgi01,PF,27,MIL,61,61,1998,620,1128,.550,67,223,.300,553,905,.611,.579,506,701,.722,119,588,707,354,64,87,198,198,1813
13,Thanasis Antetokounmpo\antetth01,SF,29,MIL,44,5,398,51,100,.510,1,11,.091,50,89,.562,.515,21,34,.618,39,55,94,19,14,9,20,62,124
14,Carmelo Anthony\anthoca01,PF,37,LAL,65,3,1703,301,677,.445,146,379,.385,155,298,.520,.552,128,154,.831,58,214,272,63,44,51,57,158,876
15,Cole Anthony\anthoco01,PG,21,ORL,62,62,2005,350,890,.393,131,385,.340,219,505,.434,.467,211,248,.851,31,308,339,362,45,16,165,164,1042
16,OG Anunoby\anunoog01,SF,24,TOR,45,45,1635,293,667,.439,109,303,.360,184,364,.505,.521,83,111,.748,70,174,244,117,68,25,74,126,778
17,Ryan Arcidiacono\arcidry01,PG,27,NYK,6,0,17,2,3,.667,2,2,1.000,0,1,.000,1.000,0,0,,0,1,1,0,0,0,0,0,6
18,Trevor Ariza\arizatr01,SF,36,LAL,22,10,415,28,82,.341,20,66,.303,8,16,.500,.463,8,15,.533,6,65,71,23,12,4,10,19,84
19,D.J. Augustin\augusdj01,PG,34,TOT,47,2,733,84,190,.442,60,138,.435,24,52,.462,.600,34,39,.872,9,49,58,95,15,0,51,27,262
19,D.J. Augustin\augusdj01,PG,34,HOU,34,2,510,55,136,.404,39,96,.406,16,40,.400,.548,33,38,.868,7,34,41,74,10,0,45,17,182
19,D.J. Augustin\augusdj01,PG,34,LAL,13,0,223,29,54,.537,21,42,.500,8,12,.667,.731,1,1,1.000,2,15,17,21,5,0,6,10,80
20,Deni Avdija\avdijde01,SF,21,WAS,74,6,1755,211,493,.428,69,217,.318,142,276,.514,.498,99,129,.767,45,335,380,135,55,39,69,167,590
21,Joel Ayayi\ayayijo01,SG,21,WAS,7,0,20,1,6,.167,0,1,.000,1,5,.200,.167,0,0,,1,2,3,4,0,0,0,0,2
22,Deandre Ayton\aytonde01,C,23,PHO,54,54,1591,412,640,.644,6,17,.353,406,623,.652,.648,101,135,.748,138,404,542,77,39,37,82,129,931
23,Udoka Azubuike\azubuud01,C,22,UTA,17,6,195,37,49,.755,0,0,,37,49,.755,.755,6,11,.545,18,53,71,0,1,11,12,25,80
24,Marvin Bagley III\baglema01,PF,22,TOT,46,23,1098,217,433,.501,22,95,.232,195,338,.577,.527,65,96,.677,102,223,325,32,22,17,37,87,521
24,Marvin Bagley III\baglema01,PF,22,SAC,30,17,656,114,246,.463,15,62,.242,99,184,.538,.494,35,47,.745,67,148,215,17,9,11,21,50,278
24,Marvin Bagley III\baglema01,PF,22,DET,16,6,442,103,187,.551,7,33,.212,96,154,.623,.570,30,49,.612,35,75,110,15,13,6,16,37,243
25,LaMelo Ball\ballla01,PG,20,CHO,69,69,2230,492,1158,.425,197,516,.382,295,642,.460,.510,202,233,.867,103,363,466,510,108,30,213,222,1383
26,Lonzo Ball\balllo01,PG,24,CHI,35,35,1212,162,383,.423,110,260,.423,52,123,.423,.567,21,28,.750,35,155,190,178,64,31,82,85,455
27,Mo Bamba\bambamo01,C,23,ORL,65,63,1679,266,558,.477,91,244,.373,175,314,.557,.558,51,64,.797,137,384,521,72,37,107,75,171,674
28,Desmond Bane\banede01,SF,23,MEM,72,72,2153,484,1051,.461,216,504,.429,268,547,.490,.563,129,144,.896,44,277,321,200,84,28,105,182,1313
29,Dalano Banton\bantoda01,SF,22,TOR,62,1,687,81,200,.405,13,51,.255,68,149,.456,.438,25,42,.595,37,85,122,97,27,10,53,66,200
30,Cat Barber\barbeca01,PG,27,ATL,3,0,13,0,4,.000,0,0,,0,4,.000,.000,0,4,.000,1,2,3,3,0,0,1,1,0
31,Harrison Barnes\barneha02,PF,29,SAC,71,71,2412,364,777,.468,135,334,.404,229,443,.517,.555,329,396,.831,76,330,406,179,52,13,115,88,1192
32,Scottie Barnes\barnesc01,PF,20,TOR,67,67,2390,416,851,.489,51,171,.298,365,680,.537,.519,141,194,.727,176,331,507,233,75,54,127,175,1024
33,RJ Barrett\barrerj01,SF,21,NYK,65,65,2252,452,1102,.410,131,377,.347,321,725,.443,.470,266,370,.719,63,322,385,188,40,16,139,136,1301
34,Will Barton\bartowi01,SG,31,DEN,66,66,2101,365,836,.437,143,397,.360,222,439,.506,.522,94,118,.797,40,282,322,255,52,31,119,105,967
35,Paris Bass\basspa01,SF,26,PHO,2,0,7,2,6,.333,0,2,.000,2,4,.500,.333,2,2,1.000,2,2,4,0,1,0,2,2,6
36,Charles Bassey\bassech01,PF,21,PHI,23,0,168,30,47,.638,0,4,.000,30,43,.698,.638,9,12,.750,22,40,62,7,5,17,8,32,69
37,Keita Bates-Diop\bateske01,SF,26,SAS,53,13,842,112,222,.505,17,49,.347,95,173,.549,.543,40,54,.741,52,152,204,36,26,14,36,55,281
38,Nicolas Batum\batumni01,PF,33,LAC,54,49,1331,165,361,.457,99,252,.393,66,109,.606,.594,20,32,.625,27,207,234,88,51,38,37,73,449
39,Kent Bazemore\bazemke01,SF,32,LAL,37,14,518,45,134,.336,29,76,.382,16,58,.276,.444,13,17,.765,13,52,65,33,24,8,19,64,132
40,Darius Bazley\bazleda01,PF,21,OKC,69,53,1924,274,649,.422,80,269,.297,194,380,.511,.484,117,170,.688,71,365,436,97,58,70,90,68,745
41,Bradley Beal\bealbr01,SG,28,WAS,40,40,1439,348,771,.451,63,210,.300,285,561,.508,.492,169,203,.833,38,151,189,265,36,15,135,95,928
42,Malik Beasley\beaslma01,SG,25,MIN,74,14,1849,313,801,.391,224,595,.376,89,206,.432,.531,43,54,.796,25,192,217,108,37,11,43,84,893
43,Jordan Bell\belljo01,C,27,CHI,1,0,2,0,0,,0,0,,0,0,,,0,0,,1,0,1,0,1,0,0,2,0
44,DeAndre' Bembry\bembrde01,SF,27,TOT,56,20,1026,124,221,.561,15,36,.417,109,185,.589,.595,21,35,.600,42,121,163,66,49,25,31,113,284
44,DeAndre' Bembry\bembrde01,SF,27,BRK,48,20,949,121,213,.568,15,36,.417,106,177,.599,.603,21,35,.600,38,114,152,60,47,25,30,104,278
44,DeAndre' Bembry\bembrde01,SF,27,MIL,8,0,77,3,8,.375,0,0,,3,8,.375,.375,0,0,,4,7,11,6,2,0,1,9,6
45,Dāvis Bertāns\bertada01,PF,29,TOT,49,0,707,84,246,.341,63,204,.309,21,42,.500,.470,34,38,.895,8,87,95,23,15,9,16,78,265
45,Dāvis Bertāns\bertada01,PF,29,WAS,34,0,501,60,171,.351,46,144,.319,14,27,.519,.485,28,30,.933,6,55,61,16,11,6,14,55,194
45,Dāvis Bertāns\bertada01,PF,29,DAL,15,0,206,24,75,.320,17,60,.283,7,15,.467,.433,6,8,.750,2,32,34,7,4,3,2,23,71
46,Patrick Beverley\beverpa01,PG,33,MIN,54,50,1383,168,411,.409,80,231,.346,88,180,.489,.506,85,118,.720,59,168,227,249,60,49,71,161,501
47,Saddiq Bey\beysa01,SF,22,DET,75,75,2531,415,1047,.396,194,562,.345,221,485,.456,.489,196,239,.820,103,322,425,214,68,16,92,121,1220
48,Khem Birch\birchkh01,C,29,TOR,48,23,886,88,181,.486,0,12,.000,88,169,.521,.486,52,68,.765,110,103,213,52,27,23,24,92,228
49,Goga Bitadze\bitadgo01,C,22,IND,47,13,655,119,229,.520,20,72,.278,99,157,.631,.563,55,84,.655,72,90,162,48,20,37,40,98,313
50,Bismack Biyombo\biyombi01,C,29,PHO,31,3,414,71,120,.592,0,0,,71,120,.592,.592,31,60,.517,53,82,135,18,11,22,22,62,173
51,Nemanja Bjelica\bjeline01,C,33,GSW,65,0,1025,141,311,.453,47,136,.346,94,175,.537,.529,52,74,.703,52,208,260,137,36,24,77,117,381
52,Eric Bledsoe\bledser01,PG,32,LAC,54,29,1361,197,468,.421,51,163,.313,146,305,.479,.475,89,117,.761,28,154,182,225,69,19,116,85,534
53,Keljin Blevins\blevike01,SF,26,POR,24,1,228,24,73,.329,14,45,.311,10,28,.357,.425,4,8,.500,13,17,30,16,5,1,12,18,66
54,Bogdan Bogdanović\bogdabo01,SG,29,ATL,56,27,1657,301,697,.432,144,400,.360,157,297,.529,.535,89,104,.856,26,195,221,173,59,13,65,120,835
55,Bojan Bogdanović\bogdabo02,PF,32,UTA,64,64,1979,394,860,.458,170,434,.392,224,426,.526,.557,201,231,.870,56,218,274,110,27,1,110,102,1159
56,Bol Bol\bolbo01,PF,22,DEN,14,0,81,15,27,.556,1,4,.250,14,23,.609,.574,2,5,.400,4,16,20,5,1,2,4,4,33
57,Leandro Bolmaro\bolmale01,SF,21,MIN,33,2,219,13,44,.295,4,17,.235,9,27,.333,.341,9,11,.818,15,24,39,17,6,0,13,25,39
58,Isaac Bonga\bongais01,SF,22,TOR,15,0,69,3,13,.231,1,4,.250,2,9,.222,.269,5,8,.625,4,3,7,4,8,2,2,10,12
59,Devin Booker\bookede01,SG,25,PHO,64,64,2203,615,1324,.465,170,450,.378,445,874,.509,.529,294,339,.867,44,278,322,316,76,26,157,165,1694
60,Brandon Boston Jr.\bostobr01,SG,20,LAC,50,0,722,117,310,.377,34,109,.312,83,201,.413,.432,57,68,.838,16,88,104,46,25,12,30,42,325
61,Chris Boucher\bouchch01,PF,29,TOR,73,9,1533,245,519,.472,58,203,.286,187,316,.592,.528,135,175,.771,163,289,452,20,47,68,38,163,683
62,James Bouknight\bouknja01,SG,21,CHO,28,0,296,48,136,.353,17,49,.347,31,87,.356,.415,27,31,.871,21,27,48,23,7,1,13,28,140
63,Avery Bradley\bradlav01,SG,31,LAL,58,42,1310,138,333,.414,77,200,.385,61,133,.459,.530,16,18,.889,31,99,130,45,49,9,37,109,369
64,Tony Bradley\bradlto01,C,24,CHI,51,7,523,64,111,.577,0,0,,64,111,.577,.577,17,25,.680,60,114,174,26,10,32,30,58,145
65,Ignas Brazdeikis\brazdig01,SF,23,ORL,36,0,366,49,120,.408,15,54,.278,34,66,.515,.471,14,19,.737,14,34,48,27,8,2,11,37,127
66,Mikal Bridges\bridgmi01,SF,25,PHO,75,75,2662,420,790,.532,111,295,.376,309,495,.624,.602,116,140,.829,71,253,324,173,89,35,60,142,1067
67,Miles Bridges\bridgmi02,PF,23,CHO,74,74,2657,553,1135,.487,141,437,.323,412,698,.590,.549,244,305,.800,86,440,526,282,72,65,144,184,1491
68,Oshae Brissett\brissos01,SF,23,IND,62,20,1401,180,441,.408,67,203,.330,113,238,.475,.484,97,141,.688,98,222,320,58,39,29,46,102,524
69,Malcolm Brogdon\brogdma01,PG,29,IND,36,36,1206,243,543,.448,58,186,.312,185,357,.518,.501,143,167,.856,33,152,185,212,30,14,77,71,687
70,Armoni Brooks\brookar01,SG-PG,23,TOT,50,9,802,97,281,.345,73,241,.303,24,40,.600,.475,16,19,.842,19,76,95,59,27,11,26,69,283
70,Armoni Brooks\brookar01,SG,23,HOU,41,8,690,87,251,.347,64,213,.300,23,38,.605,.474,16,19,.842,12,69,81,49,21,8,23,60,254
70,Armoni Brooks\brookar01,PG,23,TOR,9,1,112,10,30,.333,9,28,.321,1,2,.500,.483,0,0,,7,7,14,10,6,3,3,9,29
71,Dillon Brooks\brookdi01,SF,26,MEM,28,27,768,192,450,.427,40,131,.305,152,319,.476,.471,80,93,.860,25,63,88,70,35,7,44,93,504
72,Bruce Brown\brownbr01,SF,25,BRK,66,39,1574,223,445,.501,26,76,.342,197,369,.534,.530,78,105,.743,93,218,311,122,72,38,45,159,550
73,Charlie Brown Jr.\brownch02,SG,24,TOT,21,2,177,10,39,.256,1,12,.083,9,27,.333,.269,9,10,.900,14,18,32,6,10,4,5,18,30
73,Charlie Brown Jr.\brownch02,SG,24,DAL,3,0,15,1,5,.200,0,3,.000,1,2,.500,.200,0,0,,0,1,1,1,2,1,0,2,2
73,Charlie Brown Jr.\brownch02,SG,24,PHI,18,2,162,9,34,.265,1,9,.111,8,25,.320,.279,9,10,.900,14,17,31,5,8,3,5,16,28
74,Chaundee Brown Jr.\brownch05,SG-SF,23,TOT,5,2,104,10,32,.313,6,18,.333,4,14,.286,.406,5,6,.833,1,15,16,4,2,0,1,7,31
74,Chaundee Brown Jr.\brownch05,SF,23,LAL,2,0,21,1,7,.143,0,3,.000,1,4,.250,.143,0,0,,0,2,2,0,0,0,1,0,2
74,Chaundee Brown Jr.\brownch05,SG,23,ATL,3,2,83,9,25,.360,6,15,.400,3,10,.300,.480,5,6,.833,1,13,14,4,2,0,0,7,29
75,Greg Brown III\browngr01,SF,20,POR,41,0,467,60,145,.414,7,37,.189,53,108,.491,.438,35,55,.636,35,70,105,23,21,19,22,70,162
76,Jaylen Brown\brownja02,SF,25,BOS,60,60,2024,517,1103,.469,149,426,.350,368,677,.544,.536,219,289,.758,49,315,364,194,61,16,162,143,1402
77,Moses Brown\brownmo01,C,22,TOT,33,1,207,35,65,.538,0,0,,35,65,.538,.538,29,50,.580,22,52,74,1,6,13,14,34,99
77,Moses Brown\brownmo01,C,22,DAL,26,1,169,27,50,.540,0,0,,27,50,.540,.540,27,43,.628,16,45,61,1,3,9,14,28,81
77,Moses Brown\brownmo01,C,22,CLE,7,0,38,8,15,.533,0,0,,8,15,.533,.533,2,7,.286,6,7,13,0,3,4,0,6,18
78,Sterling Brown\brownst02,SG,26,DAL,48,3,614,56,149,.376,27,89,.303,29,60,.483,.466,14,15,.933,26,119,145,34,13,7,23,53,153
79,Troy Brown Jr.\browntr01,SF,22,CHI,61,6,984,98,236,.415,42,121,.347,56,115,.487,.504,19,25,.760,37,147,184,56,31,5,23,61,257
80,Jalen Brunson\brunsja01,PG,25,DAL,72,54,2304,463,923,.502,84,225,.373,379,698,.543,.547,158,188,.840,39,237,276,355,62,3,120,142,1168
81,Thomas Bryant\bryanth01,C,24,WAS,23,9,398,73,138,.529,11,39,.282,62,99,.626,.569,35,40,.875,26,66,92,23,6,18,18,41,192
82,Shaq Buchanan\buchash01,PG,25,MEM,2,0,10,1,4,.250,0,2,.000,1,2,.500,.250,0,0,,1,1,2,2,1,0,2,1,2
83,Reggie Bullock\bullore01,SF,30,DAL,61,30,1668,178,450,.396,123,350,.351,55,100,.550,.532,36,44,.818,28,189,217,72,37,13,34,95,515
84,Trey Burke\burketr01,PG,29,DAL,39,0,418,81,205,.395,25,80,.313,56,125,.448,.456,20,23,.870,4,27,31,52,11,0,26,37,207
85,Alec Burks\burksal01,SG,30,NYK,75,38,2106,260,667,.390,140,352,.398,120,315,.381,.495,202,245,.824,43,313,356,213,80,24,75,188,862
86,Jared Butler\butleja02,SG,21,UTA,38,1,302,55,130,.423,26,74,.351,29,56,.518,.523,7,12,.583,5,31,36,50,13,7,31,43,143
87,Jimmy Butler\butleji01,SF,32,MIA,53,53,1786,368,775,.475,23,104,.221,345,671,.514,.490,367,420,.874,98,219,317,295,89,27,110,80,1126
88,Devontae Cacok\cacokde01,PF,25,SAS,11,0,92,18,26,.692,0,0,,18,26,.692,.692,4,7,.571,7,29,36,5,7,7,2,12,40
89,Kentavious Caldwell-Pope\caldwke01,SG,28,WAS,71,71,2147,312,742,.420,144,373,.386,168,369,.455,.518,131,147,.891,39,204,243,137,77,25,84,125,899
90,Facundo Campazzo\campafa01,PG,30,DEN,63,4,1173,106,291,.364,57,189,.302,49,102,.480,.462,60,78,.769,23,94,117,216,61,23,66,123,329
91,Vlatko Čančar\cancavl01,PF,24,DEN,14,1,152,22,39,.564,7,12,.583,15,27,.556,.654,9,12,.750,6,17,23,13,2,3,8,13,60
92,Clint Capela\capelca01,C,27,ATL,67,66,1860,331,547,.605,0,1,.000,331,546,.606,.605,69,148,.466,251,541,792,88,44,86,43,150,731
93,Vernon Carey Jr.\careyve01,C,20,TOT,5,1,18,3,6,.500,0,0,,3,6,.500,.500,2,3,.667,3,2,5,0,1,0,1,1,8
93,Vernon Carey Jr.\careyve01,C,20,CHO,4,1,17,3,6,.500,0,0,,3,6,.500,.500,2,3,.667,3,2,5,0,1,0,1,1,8
93,Vernon Carey Jr.\careyve01,C,20,WAS,1,0,1,0,0,,0,0,,0,0,,,0,0,,0,0,0,0,0,0,0,0,0
94,Jevon Carter\carteje01,PG,26,TOT,60,1,813,88,229,.384,62,161,.385,26,68,.382,.520,15,18,.833,13,85,98,79,19,13,32,60,253
94,Jevon Carter\carteje01,PG,26,BRK,46,1,552,58,174,.333,42,127,.331,16,47,.340,.454,7,10,.700,9,58,67,46,14,10,26,45,165
94,Jevon Carter\carteje01,PG,26,MIL,14,0,261,30,55,.545,20,34,.588,10,21,.476,.727,8,8,1.000,4,27,31,33,5,3,6,15,88
95,Wendell Carter Jr.\cartewe01,C,22,ORL,62,61,1852,359,684,.525,70,214,.327,289,470,.615,.576,143,207,.691,139,509,648,171,36,43,117,169,931
96,Alex Caruso\carusal01,SG,27,CHI,37,14,1041,98,237,.414,41,115,.357,57,122,.467,.500,58,73,.795,29,107,136,142,67,15,55,98,295
97,Willie Cauley-Stein\caulewi01,C,28,TOT,20,2,183,16,35,.457,1,2,.500,15,33,.455,.471,1,2,.500,13,27,40,10,6,3,7,19,34
97,Willie Cauley-Stein\caulewi01,C,28,DAL,18,2,177,16,35,.457,1,2,.500,15,33,.455,.471,1,2,.500,13,25,38,9,6,3,7,17,34
97,Willie Cauley-Stein\caulewi01,C,28,PHI,2,0,6,0,0,,0,0,,0,0,,,0,0,,0,2,2,1,0,0,0,2,0
98,Ahmad Caver\caverah01,PG,25,IND,1,0,1,1,1,1.000,0,0,,1,1,1.000,1.000,0,0,,0,0,0,0,0,0,0,0,2
99,Justin Champagnie\champju01,SF,20,TOR,35,0,274,30,65,.462,9,26,.346,21,39,.538,.531,9,9,1.000,37,33,70,11,7,4,7,32,78
100,Zylan Cheatham\cheatzy01,SF,26,UTA,1,0,5,0,3,.000,0,2,.000,0,1,.000,.000,0,0,,0,0,0,0,0,0,0,0,0
101,Chris Chiozza\chiozch01,PG,26,GSW,34,1,372,24,81,.296,17,53,.321,7,28,.250,.401,2,3,.667,9,27,36,65,13,0,32,32,67
102,Marquese Chriss\chrisma01,PF,24,DAL,28,0,293,54,113,.478,7,22,.318,47,91,.516,.509,14,23,.609,26,65,91,13,12,12,17,55,129
103,Josh Christopher\chrisjo01,SG,20,HOU,68,2,1180,196,439,.446,50,165,.303,146,274,.533,.503,74,94,.787,45,118,163,133,54,11,99,81,516
104,Gary Clark\clarkga01,PF,27,NOP,34,1,331,27,76,.355,24,63,.381,3,13,.231,.513,6,8,.750,17,63,80,14,11,7,7,19,84
105,Brandon Clarke\clarkbr01,PF,25,MEM,59,1,1150,262,408,.642,4,21,.190,258,387,.667,.647,82,125,.656,127,198,325,79,34,67,32,116,610
106,Jordan Clarkson\clarkjo01,SG,29,UTA,72,1,1940,427,1022,.418,174,544,.320,253,478,.529,.503,130,155,.839,61,186,247,167,60,16,118,142,1158
107,Nic Claxton\claxtni01,C,22,BRK,40,19,819,151,226,.668,0,0,,151,226,.668,.668,47,80,.588,78,140,218,36,20,47,30,86,349
108,Amir Coffey\coffeam01,SG,24,LAC,62,28,1465,188,425,.442,84,232,.362,104,193,.539,.541,90,106,.849,24,151,175,109,34,14,42,83,550
109,John Collins\collijo01,PF,24,ATL,54,53,1663,339,644,.526,64,176,.364,275,468,.588,.576,134,169,.793,93,329,422,98,33,56,60,164,876
110,Zach Collins\colliza01,PF,24,SAS,21,2,354,51,112,.455,11,33,.333,40,79,.506,.504,27,33,.818,38,68,106,42,7,16,32,48,140
111,Darren Collison\collida01,PG,34,LAL,3,0,37,2,7,.286,0,3,.000,2,4,.500,.286,0,0,,0,4,4,2,1,0,1,5,4
112,Mike Conley\conlemi01,PG,34,UTA,66,66,1866,305,714,.427,150,373,.402,155,341,.455,.532,123,152,.809,42,156,198,349,89,20,109,125,883
113,Pat Connaughton\connapa01,SG,29,MIL,58,18,1545,210,449,.468,136,335,.406,74,114,.649,.619,41,50,.820,40,213,253,72,53,14,32,79,597
114,Tyler Cook\cookty01,PF,24,CHI,19,2,196,22,36,.611,0,0,,22,36,.611,.611,20,31,.645,16,36,52,3,4,4,7,26,64
115,Sharife Cooper\coopesh01,PG,20,ATL,11,0,35,3,14,.214,1,6,.167,2,8,.250,.250,0,0,,0,5,5,5,0,0,5,1,7
116,Petr Cornelie\cornepe01,PF,26,DEN,13,0,38,5,15,.333,1,8,.125,4,7,.571,.367,3,4,.750,7,7,14,3,1,1,4,7,14
117,DeMarcus Cousins\couside01,C,31,TOT,42,6,651,131,292,.449,33,111,.297,98,181,.541,.505,85,112,.759,66,181,247,60,34,18,72,120,380
117,DeMarcus Cousins\couside01,C,31,MIL,17,5,287,55,118,.466,13,48,.271,42,70,.600,.521,31,38,.816,24,74,98,18,16,8,16,46,154
117,DeMarcus Cousins\couside01,C,31,DEN,25,1,364,76,174,.437,20,63,.317,56,111,.505,.494,54,74,.730,42,107,149,42,18,10,56,74,226
118,Robert Covington\covinro01,PF-SF,31,TOT,64,40,1778,178,442,.403,106,297,.357,72,145,.497,.523,48,57,.842,54,302,356,86,96,86,71,171,510
118,Robert Covington\covinro01,PF,31,POR,48,40,1431,128,336,.381,79,230,.343,49,106,.462,.499,30,36,.833,41,233,274,68,74,63,58,132,365
118,Robert Covington\covinro01,SF,31,LAC,16,0,347,50,106,.472,27,67,.403,23,39,.590,.599,18,21,.857,13,69,82,18,22,23,13,39,145
119,Torrey Craig\craigto01,SF,31,TOT,71,16,1468,179,395,.453,66,203,.325,113,192,.589,.537,39,52,.750,78,215,293,86,39,32,61,134,463
119,Torrey Craig\craigto01,SF,31,IND,51,14,1034,128,281,.456,46,138,.333,82,143,.573,.537,27,35,.771,59,136,195,58,24,19,39,95,329
119,Torrey Craig\craigto01,SF,31,PHO,20,2,434,51,114,.447,20,65,.308,31,49,.633,.535,12,17,.706,19,79,98,28,15,13,22,39,134
120,Jae Crowder\crowdja01,PF,31,PHO,63,63,1775,207,513,.404,120,343,.350,87,170,.512,.520,67,85,.788,29,305,334,114,87,28,55,161,601
121,Jarrett Culver\culveja01,SG,22,MEM,35,0,295,46,117,.393,10,40,.250,36,77,.468,.436,14,29,.483,13,31,44,31,19,5,17,38,116
122,Jarron Cumberland\cumbeja01,SG,24,POR,3,0,12,1,2,.500,0,1,.000,1,1,1.000,.500,0,0,,1,2,3,1,0,0,0,2,2
123,Cade Cunningham\cunnica01,PG,20,DET,59,59,1936,390,946,.412,108,339,.319,282,607,.465,.469,124,148,.838,57,281,338,328,70,41,215,184,1012
124,Seth Curry\curryse01,SG,31,TOT,60,60,2011,342,700,.489,147,347,.424,195,353,.552,.594,75,86,.872,19,170,189,220,50,14,105,137,906
124,Seth Curry\curryse01,SG,31,PHI,45,45,1566,256,528,.485,100,250,.400,156,278,.561,.580,64,73,.877,17,134,151,181,36,11,84,101,676
124,Seth Curry\curryse01,SG,31,BRK,15,15,445,86,172,.500,47,97,.485,39,75,.520,.637,11,13,.846,2,36,38,39,14,3,21,36,230
125,Stephen Curry\curryst01,PG,33,GSW,64,64,2211,535,1224,.437,285,750,.380,250,474,.527,.554,275,298,.923,34,301,335,404,85,23,206,130,1630
126,Anthony Davis\davisan02,C,28,LAL,37,37,1297,341,635,.537,12,66,.182,329,569,.578,.546,161,227,.709,104,256,360,107,45,86,76,93,855
127,Ed Davis\davised01,C,32,CLE,27,3,186,11,16,.688,0,0,,11,16,.688,.688,6,14,.429,13,48,61,6,3,8,5,31,28
128,Terence Davis\daviste02,SG,24,SAC,30,11,536,113,267,.423,49,149,.329,64,118,.542,.515,36,44,.818,11,83,94,40,25,11,33,70,311
129,Gabriel Deck\deckga01,PF,26,OKC,7,0,56,8,14,.571,2,4,.500,6,10,.600,.643,0,0,,1,5,6,5,1,0,2,2,18
130,Dewayne Dedmon\dedmode01,C,32,MIA,64,15,1016,154,276,.558,19,43,.442,135,233,.579,.592,69,89,.775,104,269,373,46,21,39,66,166,396
131,Sam Dekker\dekkesa01,PF,27,TOR,1,0,1,0,0,,0,0,,0,0,,,0,0,,0,0,0,0,0,0,0,0,0
132,Javin DeLaurier\delauja01,C,23,MIL,1,0,3,0,0,,0,0,,0,0,,,0,0,,0,1,1,0,1,0,0,1,0
133,DeMar DeRozan\derozde01,PF,32,CHI,70,70,2526,710,1409,.504,45,130,.346,665,1279,.520,.520,472,542,.871,54,319,373,350,61,24,167,161,1937
134,Mamadi Diakite\diakima01,PF,25,OKC,13,3,188,25,47,.532,0,5,.000,25,42,.595,.532,6,11,.545,17,42,59,2,5,9,7,33,56
135,Cheick Diallo\diallch01,C,25,DET,3,0,31,3,8,.375,0,0,,3,8,.375,.375,5,6,.833,4,8,12,0,1,0,1,6,11
136,Hamidou Diallo\diallha01,SG,23,DET,58,29,1269,261,526,.496,23,93,.247,238,433,.550,.518,91,140,.650,69,208,277,73,71,17,58,143,636
137,Gorgui Dieng\dienggo01,C,32,ATL,42,3,363,52,106,.491,28,62,.452,24,44,.545,.623,19,26,.731,32,87,119,33,11,13,20,49,151
138,Spencer Dinwiddie\dinwisp01,PG,28,TOT,61,51,1850,285,693,.411,102,308,.331,183,385,.475,.485,180,230,.783,43,223,266,325,41,12,93,144,852
138,Spencer Dinwiddie\dinwisp01,PG,28,WAS,44,44,1330,185,492,.376,70,226,.310,115,266,.432,.447,116,143,.811,36,171,207,256,27,7,73,107,556
138,Spencer Dinwiddie\dinwisp01,PG,28,DAL,17,7,520,100,201,.498,32,82,.390,68,119,.571,.577,64,87,.736,7,52,59,69,14,5,20,37,296
139,Donte DiVincenzo\divindo01,SG,25,TOT,36,1,840,96,279,.344,60,182,.330,36,97,.371,.452,54,64,.844,37,101,138,95,38,5,56,56,306
139,Donte DiVincenzo\divindo01,SG,25,MIL,17,0,341,39,118,.331,21,74,.284,18,44,.409,.419,23,27,.852,18,42,60,29,11,3,28,26,122
139,Donte DiVincenzo\divindo01,SG,25,SAC,19,1,499,57,161,.354,39,108,.361,18,53,.340,.475,31,37,.838,19,59,78,66,27,2,28,30,184
140,Luka Dončić\doncilu01,PG,22,DAL,58,58,2066,567,1250,.454,176,503,.350,391,747,.523,.524,309,422,.732,51,479,530,492,67,31,262,133,1619
141,Luguentz Dort\dortlu01,SF,22,OKC,51,51,1665,293,726,.404,130,391,.332,163,335,.487,.493,161,191,.843,38,174,212,88,46,18,88,149,877
142,Ayo Dosunmu\dosunay01,SG,22,CHI,70,34,1908,244,471,.518,64,168,.381,180,303,.594,.586,46,68,.676,25,169,194,231,52,28,92,169,598
143,Damyean Dotson\dotsoda01,SG,27,NYK,2,0,21,2,4,.500,0,1,.000,2,3,.667,.500,0,0,,0,2,2,1,0,0,0,0,4
144,Devon Dotson\dotsode01,PG,22,CHI,11,0,85,11,23,.478,2,9,.222,9,14,.643,.522,5,9,.556,1,8,9,15,1,0,5,11,29
145,Sekou Doumbouya\doumbse01,PF,21,LAL,2,0,16,5,8,.625,1,2,.500,4,6,.667,.688,3,4,.750,2,4,6,0,3,2,2,1,14
146,Jeff Dowtin\dowtije01,PG,24,TOT,8,0,98,8,24,.333,1,8,.125,7,16,.438,.354,0,0,,8,10,18,10,3,1,4,4,17
146,Jeff Dowtin\dowtije01,PG,24,GSW,4,0,28,3,6,.500,0,1,.000,3,5,.600,.500,0,0,,1,6,7,3,0,1,1,2,6
146,Jeff Dowtin\dowtije01,PG,24,MIL,1,0,3,0,1,.000,0,1,.000,0,0,,.000,0,0,,0,0,0,0,0,0,0,0,0
146,Jeff Dowtin\dowtije01,PG,24,ORL,3,0,67,5,17,.294,1,6,.167,4,11,.364,.324,0,0,,7,4,11,7,3,0,3,2,11
147,PJ Dozier\doziepj01,SG,25,DEN,18,0,340,36,99,.364,15,48,.313,21,51,.412,.439,10,13,.769,14,49,63,29,11,6,13,33,97
148,Goran Dragić\dragigo01,PG,35,TOT,19,8,450,51,138,.370,14,56,.250,37,82,.451,.420,27,33,.818,11,46,57,81,16,4,28,42,143
148,Goran Dragić\dragigo01,PG,35,TOR,5,2,90,13,34,.382,4,14,.286,9,20,.450,.441,10,10,1.000,2,12,14,9,5,1,1,8,40
148,Goran Dragić\dragigo01,PG,35,BRK,14,6,360,38,104,.365,10,42,.238,28,62,.452,.413,17,23,.739,9,34,43,72,11,3,27,34,103
149,Andre Drummond\drumman01,C,28,TOT,66,29,1280,213,374,.570,0,3,.000,213,371,.574,.570,79,155,.510,200,399,599,122,70,61,109,170,505
149,Andre Drummond\drumman01,C,28,PHI,49,12,902,128,238,.538,0,2,.000,128,236,.542,.538,42,82,.512,136,297,433,97,56,45,79,121,298
149,Andre Drummond\drumman01,C,28,BRK,17,17,378,85,136,.625,0,1,.000,85,135,.630,.625,37,73,.507,64,102,166,25,14,16,30,49,207
150,Chris Duarte\duartch01,SG,24,IND,55,39,1541,268,621,.432,94,255,.369,174,366,.475,.507,90,112,.804,41,185,226,114,56,10,90,95,720
151,David Duke Jr.\dukeda01,PG,22,BRK,21,7,340,39,108,.361,9,37,.243,30,71,.423,.403,17,21,.810,30,37,67,17,14,7,9,36,104
152,Kris Dunn\dunnkr01,PG,27,POR,9,1,212,30,61,.492,1,5,.200,29,56,.518,.500,13,13,1.000,3,24,27,43,17,2,18,28,74
153,Kevin Durant\duranke01,PF,33,BRK,48,48,1760,504,971,.519,93,253,.368,411,718,.572,.567,314,347,.905,26,322,348,293,42,42,161,97,1415
154,Jaime Echenique\echenja01,C,24,WAS,1,0,3,0,0,,0,0,,0,0,,,0,0,,0,0,0,0,0,0,0,0,0
155,Anthony Edwards\edwaran01,SG,20,MIN,66,66,2269,494,1138,.434,197,552,.357,297,586,.507,.521,198,254,.780,56,255,311,246,99,44,178,151,1383
156,Kessler Edwards\edwarke02,SF,21,BRK,41,21,854,93,226,.412,42,115,.365,51,111,.459,.504,12,15,.800,38,111,149,26,26,19,38,71,240
157,Rob Edwards\edwarro01,SG,25,OKC,2,0,11,1,4,.250,1,4,.250,0,0,,.375,0,0,,0,3,3,0,0,0,1,0,3
158,CJ Elleby\ellebcj01,SF,21,POR,51,21,973,102,256,.398,29,99,.293,73,157,.465,.455,50,69,.725,60,136,196,69,30,16,49,102,283
159,Wayne Ellington\ellinwa01,SG,34,LAL,40,9,742,87,213,.408,75,191,.393,12,22,.545,.585,4,5,.800,10,58,68,29,23,4,16,39,253
160,Joel Embiid\embiijo01,C,27,PHI,61,61,2039,578,1183,.489,81,226,.358,497,957,.519,.523,587,718,.818,132,561,693,257,71,89,183,165,1824
161,James Ennis III\ennisja01,SF,31,TOT,7,0,56,11,24,.458,3,8,.375,8,16,.500,.521,4,5,.800,5,7,12,3,2,2,2,5,29
161,James Ennis III\ennisja01,SF,31,BRK,2,0,14,2,7,.286,1,2,.500,1,5,.200,.357,0,0,,2,3,5,0,1,1,0,0,5
161,James Ennis III\ennisja01,SF,31,LAC,2,0,28,7,11,.636,2,4,.500,5,7,.714,.727,4,4,1.000,2,3,5,0,1,1,1,4,20
161,James Ennis III\ennisja01,SF,31,DEN,3,0,14,2,6,.333,0,2,.000,2,4,.500,.333,0,1,.000,1,1,2,3,0,0,1,1,4
162,Drew Eubanks\eubandr01,C,24,TOT,65,25,1060,178,304,.586,3,16,.188,175,288,.608,.590,88,116,.759,118,220,338,79,24,36,70,99,447
162,Drew Eubanks\eubandr01,C,24,SAS,49,9,595,84,159,.528,1,8,.125,83,151,.550,.531,59,79,.747,64,132,196,50,13,30,46,61,228
162,Drew Eubanks\eubandr01,C,24,POR,16,16,465,94,145,.648,2,8,.250,92,137,.672,.655,29,37,.784,54,88,142,29,11,6,24,38,219
163,Tacko Fall\fallta01,C,26,CLE,11,1,59,5,12,.417,0,0,,5,12,.417,.417,2,7,.286,7,16,23,2,0,6,3,3,12
164,Derrick Favors\favorde01,C,30,OKC,39,18,653,94,182,.516,2,16,.125,92,166,.554,.522,16,25,.640,58,126,184,25,17,12,9,62,206
165,Bruno Fernando\fernabr01,C,23,TOT,28,0,112,24,38,.632,1,2,.500,23,36,.639,.645,10,14,.714,14,24,38,4,0,7,9,18,59
165,Bruno Fernando\fernabr01,C,23,BOS,20,0,58,7,14,.500,1,1,1.000,6,13,.462,.536,4,5,.800,7,8,15,4,0,3,5,6,19
165,Bruno Fernando\fernabr01,C,23,HOU,8,0,54,17,24,.708,0,1,.000,17,23,.739,.708,6,9,.667,7,16,23,0,0,4,4,12,40
166,Dorian Finney-Smith\finnedo01,PF,28,DAL,73,73,2421,290,634,.457,149,391,.381,141,243,.580,.575,52,78,.667,116,240,356,135,80,35,77,168,781
167,Malik Fitts\fittsma01,PF,24,TOT,12,0,46,3,13,.231,3,8,.375,0,5,.000,.346,0,0,,0,13,13,0,0,0,2,3,9
167,Malik Fitts\fittsma01,PF,24,UTA,7,0,35,2,9,.222,2,4,.500,0,5,.000,.333,0,0,,0,10,10,0,0,0,2,3,6
167,Malik Fitts\fittsma01,PF,24,BOS,5,0,11,1,4,.250,1,4,.250,0,0,,.375,0,0,,0,3,3,0,0,0,0,0,3
168,Malachi Flynn\flynnma01,PG,23,TOR,40,5,479,66,162,.407,27,81,.333,39,81,.481,.491,14,23,.609,9,48,57,63,18,4,11,42,173
169,Bryn Forbes\forbebr01,SG,28,TOT,72,1,1237,223,521,.428,116,283,.410,107,238,.450,.539,72,80,.900,10,82,92,72,24,5,55,92,634
169,Bryn Forbes\forbebr01,SG,28,SAS,40,1,676,128,296,.432,63,151,.417,65,145,.448,.539,44,49,.898,4,59,63,41,17,3,33,42,363
169,Bryn Forbes\forbebr01,SG,28,DEN,32,0,561,95,225,.422,53,132,.402,42,93,.452,.540,28,31,.903,6,23,29,31,7,2,22,50,271
170,Aleem Ford\fordal03,SF,24,ORL,5,0,74,6,20,.300,2,15,.133,4,5,.800,.350,0,0,,2,13,15,2,1,0,4,7,14
171,Trent Forrest\forretr01,PG,23,UTA,58,5,746,73,152,.480,5,27,.185,68,125,.544,.497,38,48,.792,23,73,96,101,30,5,46,42,189
172,Evan Fournier\fournev01,SG,29,NYK,74,74,2191,374,900,.416,224,577,.388,150,323,.464,.540,71,102,.696,33,160,193,156,72,18,99,164,1043
173,De'Aaron Fox\foxde01,PG,24,SAC,59,59,2083,516,1092,.473,74,249,.297,442,843,.524,.506,261,348,.750,25,206,231,330,68,25,168,172,1367
174,Tim Frazier\fraziti01,PG,31,TOT,12,3,208,14,45,.311,6,17,.353,8,28,.286,.378,5,9,.556,5,14,19,34,3,1,15,27,39
174,Tim Frazier\fraziti01,PG,31,ORL,10,3,200,13,43,.302,6,17,.353,7,26,.269,.372,5,9,.556,5,14,19,33,3,1,13,24,37
174,Tim Frazier\fraziti01,PG,31,CLE,2,0,8,1,2,.500,0,0,,1,2,.500,.500,0,0,,0,0,0,1,0,0,2,3,2
175,Enes Freedom\kanteen01,C,29,BOS,35,1,411,51,97,.526,2,5,.400,49,92,.533,.536,24,28,.857,61,99,160,8,5,14,20,42,128
176,Markelle Fultz\fultzma01,PG,23,ORL,12,0,219,48,105,.457,3,10,.300,45,95,.474,.471,16,20,.800,4,25,29,52,12,3,24,13,115
177,Wenyen Gabriel\gabriwe01,PF,24,TOT,18,4,227,31,74,.419,7,25,.280,24,49,.490,.466,13,24,.542,24,38,62,7,5,6,9,44,82
177,Wenyen Gabriel\gabriwe01,PF,24,BRK,1,0,1,0,0,,0,0,,0,0,,,0,0,,0,1,1,0,0,0,0,0,0
177,Wenyen Gabriel\gabriwe01,PF,24,LAC,6,0,46,5,13,.385,2,5,.400,3,8,.375,.462,2,4,.500,5,9,14,2,1,2,3,11,14
177,Wenyen Gabriel\gabriwe01,PF,24,LAL,11,4,180,26,61,.426,5,20,.250,21,41,.512,.467,11,20,.550,19,28,47,5,4,4,6,33,68
178,Daniel Gafford\gaffoda01,C,23,WAS,64,51,1283,249,359,.694,0,0,,249,359,.694,.694,87,123,.707,139,227,366,61,25,91,62,152,585
179,Danilo Gallinari\gallida01,PF,33,ATL,61,15,1525,229,539,.425,99,265,.374,130,274,.474,.517,136,150,.907,32,251,283,94,26,11,33,86,693
180,Langston Galloway\gallola01,SG,30,TOT,7,0,107,6,26,.231,2,16,.125,4,10,.400,.269,0,0,,3,15,18,12,1,0,6,7,14
180,Langston Galloway\gallola01,SG,30,BRK,4,0,58,5,13,.385,2,8,.250,3,5,.600,.462,0,0,,1,7,8,5,0,0,5,5,12
180,Langston Galloway\gallola01,SG,30,MIL,3,0,49,1,13,.077,0,8,.000,1,5,.200,.077,0,0,,2,8,10,7,1,0,1,2,2
181,Darius Garland\garlada01,PG,22,CLE,61,61,2185,483,1043,.463,153,415,.369,330,628,.525,.536,195,215,.907,35,171,206,527,76,6,233,108,1314
182,Marcus Garrett\garrema01,SG,23,MIA,12,0,128,5,21,.238,1,4,.250,4,17,.235,.262,2,5,.400,9,14,23,7,5,3,2,16,13
183,Usman Garuba\garubus01,PF,19,HOU,18,0,129,10,27,.370,4,16,.250,6,11,.545,.444,3,4,.750,10,31,41,9,8,7,4,13,27
184,Luka Garza\garzalu01,C,23,DET,31,5,358,58,129,.450,14,42,.333,44,87,.506,.504,36,55,.655,51,39,90,16,9,5,17,52,166
185,Rudy Gay\gayru01,PF,35,UTA,51,1,965,144,357,.403,65,192,.339,79,165,.479,.494,60,76,.789,54,172,226,51,24,15,43,91,413
186,Paul George\georgpa01,SF,31,LAC,26,26,924,234,556,.421,70,217,.323,164,339,.484,.484,103,117,.880,11,174,185,142,53,10,109,65,641
187,Taj Gibson\gibsota01,C,36,NYK,47,4,851,76,141,.539,13,29,.448,63,112,.563,.585,35,44,.795,78,129,207,27,19,37,24,130,200
188,Josh Giddey\giddejo01,SG,19,OKC,54,54,1700,281,670,.419,56,213,.263,225,457,.492,.461,56,79,.709,98,323,421,345,51,20,171,88,674
189,Shai Gilgeous-Alexander\gilgesh01,PG,23,OKC,56,56,1942,477,1052,.453,89,297,.300,388,755,.514,.496,328,405,.810,37,241,278,331,71,46,154,142,1371
190,Anthony Gill\gillan01,PF,29,WAS,37,0,334,48,75,.640,11,18,.611,37,57,.649,.713,28,37,.757,23,39,62,21,4,10,12,46,135
191,Freddie Gillespie\gillefr01,PF,24,ORL,9,2,119,9,22,.409,0,1,.000,9,21,.429,.409,3,7,.429,13,23,36,5,3,9,5,18,21
192,Rudy Gobert\goberru01,C,29,UTA,59,59,1885,321,451,.712,0,2,.000,321,449,.715,.712,261,372,.702,214,645,859,66,38,126,103,152,903
193,Brandon Goodwin\goodwbr01,PG,26,CLE,31,5,451,58,137,.423,18,52,.346,40,85,.471,.489,20,32,.625,14,51,65,89,23,1,31,35,154
194,Jordan Goodwin\goodwjo01,SG,23,WAS,2,0,6,0,3,.000,0,1,.000,0,2,.000,.000,0,0,,0,1,1,0,0,0,0,1,0
195,Aaron Gordon\gordoaa01,PF,26,DEN,70,70,2195,397,775,.512,75,237,.316,322,538,.599,.561,159,215,.740,120,280,400,174,43,40,122,140,1028
196,Eric Gordon\gordoer01,SG,33,HOU,57,46,1669,268,564,.475,124,301,.412,144,263,.548,.585,105,135,.778,15,98,113,154,28,18,107,63,765
197,Devonte' Graham\grahade01,PG,26,NOP,70,61,2058,283,783,.361,186,540,.344,97,243,.399,.480,112,133,.842,37,136,173,301,67,11,100,92,864
198,Jerami Grant\grantje01,PF,27,DET,47,47,1500,298,699,.426,91,254,.358,207,445,.465,.491,217,259,.838,28,163,191,111,44,49,85,107,904
199,Hassani Gravett\graveha01,PG,25,ORL,8,3,171,18,38,.474,11,26,.423,7,12,.583,.618,3,4,.750,1,20,21,20,5,1,9,13,50
200,Danny Green\greenda02,SF,34,PHI,54,25,1179,108,280,.386,86,236,.364,22,44,.500,.539,10,12,.833,25,106,131,52,50,32,38,91,312
201,Draymond Green\greendr01,PF,31,GSW,40,38,1157,115,222,.518,13,50,.260,102,172,.593,.547,50,79,.633,43,248,291,280,54,41,121,112,293
202,Jalen Green\greenja05,SG,19,HOU,61,61,1908,345,828,.417,133,398,.334,212,430,.493,.497,159,198,.803,30,171,201,160,41,17,125,91,982
203,JaMychal Green\greenja01,PF,31,DEN,62,7,1000,146,307,.476,33,122,.270,113,185,.611,.529,76,87,.874,73,188,261,52,40,25,54,145,401
204,Javonte Green\greenja02,SF,28,CHI,58,44,1383,156,289,.540,33,92,.359,123,197,.624,.597,76,92,.826,85,164,249,56,56,30,29,121,421
205,Jeff Green\greenje02,C,35,DEN,71,59,1760,265,509,.521,52,163,.319,213,346,.616,.572,154,185,.832,40,181,221,89,25,26,67,141,736
206,Josh Green\greenjo02,SG,21,DAL,60,3,924,113,227,.498,22,64,.344,91,163,.558,.546,30,43,.698,49,92,141,73,40,14,38,103,278
207,Blake Griffin\griffbl01,PF,32,BRK,55,24,952,133,312,.426,38,144,.264,95,168,.565,.487,55,76,.724,60,166,226,105,27,14,31,93,359
208,Quentin Grimes\grimequ01,SG,21,NYK,45,6,770,94,230,.409,72,185,.389,22,45,.489,.565,13,19,.684,23,67,90,42,31,11,28,71,273
209,Kyle Guy\guyky01,SG,24,MIA,19,0,186,26,65,.400,14,40,.350,12,25,.480,.508,8,12,.667,4,13,17,17,7,1,13,12,74
210,Rui Hachimura\hachiru01,PF,23,WAS,34,5,701,135,277,.487,42,91,.462,93,186,.500,.563,32,43,.744,18,101,119,34,21,5,26,43,344
211,Tyrese Haliburton\halibty01,SG-PG,21,TOT,71,71,2479,387,837,.462,150,367,.409,237,470,.504,.552,136,163,.834,54,229,283,573,122,45,182,108,1060
211,Tyrese Haliburton\halibty01,SG,21,SAC,51,51,1757,268,586,.457,104,252,.413,164,334,.491,.546,87,104,.837,39,160,199,379,86,34,115,71,727
211,Tyrese Haliburton\halibty01,PG,21,IND,20,20,722,119,251,.474,46,115,.400,73,136,.537,.566,49,59,.831,15,69,84,194,36,11,67,37,333
212,Tyler Hall\hallty01,SG,24,NYK,1,0,2,0,0,,0,0,,0,0,,,0,0,,0,0,0,0,0,0,0,0,0
213,R.J. Hampton\hamptrj01,SG,20,ORL,58,10,1221,151,389,.388,58,160,.363,93,229,.406,.463,63,102,.618,18,153,171,135,39,13,76,90,423
214,Tim Hardaway Jr.\hardati02,SG,29,DAL,42,20,1245,209,530,.394,102,304,.336,107,226,.473,.491,78,103,.757,13,143,156,92,38,6,34,74,598
215,James Harden\hardeja01,PG-SG,32,TOT,58,58,2154,372,899,.414,133,396,.336,239,503,.475,.488,426,487,.875,49,408,457,585,77,34,258,142,1303
215,James Harden\hardeja01,PG,32,BRK,44,44,1627,292,706,.414,102,307,.332,190,399,.476,.486,304,350,.869,42,309,351,447,56,31,212,105,990
215,James Harden\hardeja01,SG,32,PHI,14,14,527,80,193,.415,31,89,.348,49,104,.471,.495,122,137,.891,7,99,106,138,21,3,46,37,313
216,Maurice Harkless\harklma01,SF,28,SAC,47,24,863,83,181,.459,31,101,.307,52,80,.650,.544,20,28,.714,12,100,112,23,29,24,31,77,217
217,Jared Harper\harpeja01,PG,24,NOP,2,0,10,3,7,.429,1,2,.500,2,5,.400,.500,0,0,,1,0,1,3,0,1,1,2,7
218,Montrezl Harrell\harremo01,C,28,TOT,66,3,1540,335,524,.639,4,17,.235,331,507,.653,.643,208,290,.717,144,273,417,131,27,40,68,128,882
218,Montrezl Harrell\harremo01,C,28,WAS,46,3,1117,247,383,.645,4,15,.267,243,368,.660,.650,149,205,.727,96,213,309,96,18,31,50,88,647
218,Montrezl Harrell\harremo01,C,28,CHO,20,0,423,88,141,.624,0,2,.000,88,139,.633,.624,59,85,.694,48,60,108,35,9,9,18,40,235
219,Gary Harris\harriga01,SG,27,ORL,61,30,1730,240,553,.434,116,302,.384,124,251,.494,.539,83,95,.874,36,86,122,108,59,9,61,112,679
220,Joe Harris\harrijo01,SF,30,BRK,14,14,423,56,124,.452,41,88,.466,15,36,.417,.617,5,6,.833,5,51,56,14,7,2,16,31,158
221,Tobias Harris\harrito02,PF,29,PHI,65,65,2272,446,925,.482,84,236,.356,362,689,.525,.528,162,192,.844,70,378,448,224,36,38,102,137,1138
222,Shaquille Harrison\harrish01,SG,28,BRK,2,0,23,2,6,.333,0,2,.000,2,4,.500,.333,0,0,,1,3,4,3,1,1,2,3,4
223,Josh Hart\hartjo01,SG-SF,26,TOT,54,53,1791,287,569,.504,73,213,.343,214,356,.601,.569,160,211,.758,62,326,388,224,61,13,114,150,807
223,Josh Hart\hartjo01,SG,26,NOP,41,40,1374,195,386,.505,42,130,.323,153,256,.598,.560,116,154,.753,53,265,318,168,45,11,81,118,548
223,Josh Hart\hartjo01,SF,26,POR,13,13,417,92,183,.503,31,83,.373,61,100,.610,.587,44,57,.772,9,61,70,56,16,2,33,32,259
224,Isaiah Hartenstein\harteis01,C,23,LAC,61,0,1051,202,319,.633,6,16,.375,196,303,.647,.643,77,117,.658,99,183,282,131,47,71,74,149,487
225,Udonis Haslem\hasleud01,C,41,MIA,11,0,61,13,25,.520,1,3,.333,12,22,.545,.540,3,3,1.000,4,15,19,3,1,1,4,11,30
226,Sam Hauser\hausesa01,SF,24,BOS,22,0,117,17,37,.459,15,33,.455,2,4,.500,.662,0,0,,4,16,20,4,1,2,2,7,49
227,Jaxson Hayes\hayesja02,C,21,NOP,63,21,1235,212,334,.635,15,42,.357,197,292,.675,.657,127,165,.770,99,180,279,38,26,51,51,145,566
228,Killian Hayes\hayeski01,PG,20,DET,59,35,1458,140,382,.366,37,139,.266,103,243,.424,.415,52,68,.765,34,156,190,251,62,31,105,165,369
229,Gordon Hayward\haywago01,SF,31,CHO,48,48,1547,281,611,.460,85,218,.390,196,393,.499,.529,126,149,.846,38,183,221,173,46,22,80,85,773
230,Aaron Henry\henryaa01,SF,22,PHI,6,0,17,1,5,.200,0,1,.000,1,4,.250,.200,0,0,,0,1,1,0,0,2,2,2,2
231,Juancho Hernangómez\hernaju01,PF,26,TOT,34,6,320,23,71,.324,14,51,.275,9,20,.450,.423,14,25,.560,20,54,74,14,11,9,15,17,74
231,Juancho Hernangómez\hernaju01,PF,26,BOS,18,0,96,5,27,.185,3,18,.167,2,9,.222,.241,6,9,.667,9,16,25,3,4,2,6,7,19
231,Juancho Hernangómez\hernaju01,PF,26,SAS,5,0,51,2,6,.333,0,3,.000,2,3,.667,.333,3,4,.750,4,11,15,3,1,1,2,0,7
231,Juancho Hernangómez\hernaju01,PF,26,UTA,11,6,173,16,38,.421,11,30,.367,5,8,.625,.566,5,12,.417,7,27,34,8,6,6,7,10,48
232,Willy Hernangómez\hernawi01,C,27,NOP,46,6,734,152,285,.533,4,11,.364,148,274,.540,.540,93,123,.756,121,172,293,53,19,18,47,85,401
233,Tyler Herro\herroty01,SG,22,MIA,61,10,1987,465,1046,.445,159,409,.389,306,637,.480,.521,179,205,.873,30,261,291,236,42,8,157,83,1268
234,Buddy Hield\hieldbu01,SG,29,TOT,75,26,2291,407,1007,.404,242,657,.368,165,350,.471,.524,106,122,.869,58,263,321,202,68,23,135,165,1162
234,Buddy Hield\hieldbu01,SG,29,SAC,55,6,1574,265,693,.382,182,495,.368,83,198,.419,.514,80,92,.870,43,178,221,105,48,15,90,113,792
234,Buddy Hield\hieldbu01,SG,29,IND,20,20,717,142,314,.452,60,162,.370,82,152,.539,.548,26,30,.867,15,85,100,97,20,8,45,52,370
235,Haywood Highsmith\highsha01,SF,25,MIA,16,0,117,9,26,.346,7,17,.412,2,9,.222,.481,2,4,.500,7,14,21,2,1,2,2,10,27
236,George Hill\hillge01,SG,35,MIL,47,17,1142,111,254,.437,40,127,.315,71,127,.559,.516,50,54,.926,35,107,142,109,37,6,37,61,312
237,Malcolm Hill\hillma01,SF-SG,26,TOT,17,0,197,23,49,.469,13,34,.382,10,15,.667,.602,11,14,.786,11,21,32,5,6,3,2,22,70
237,Malcolm Hill\hillma01,SG,26,ATL,3,0,46,5,8,.625,3,5,.600,2,3,.667,.813,4,4,1.000,2,4,6,1,4,1,0,7,17
237,Malcolm Hill\hillma01,SF,26,CHI,14,0,151,18,41,.439,10,29,.345,8,12,.667,.561,7,10,.700,9,17,26,4,2,2,2,15,53
238,Solomon Hill\hillso01,PF,30,ATL,13,1,139,3,20,.150,2,13,.154,1,7,.143,.200,0,0,,6,17,23,12,4,2,1,16,8
239,Nate Hinton\hintona01,SG,22,IND,2,0,2,0,1,.000,0,0,,0,1,.000,.000,0,0,,0,0,0,0,0,0,1,0,0
240,Jaylen Hoard\hoardja01,SF,22,OKC,1,0,2,0,1,.000,0,0,,0,1,.000,.000,0,0,,1,1,2,0,0,0,0,0,0
241,Aaron Holiday\holidaa01,PG,25,TOT,58,14,953,144,308,.468,36,91,.396,108,217,.498,.526,50,58,.862,20,91,111,141,40,9,61,81,374
241,Aaron Holiday\holidaa01,PG,25,WAS,41,14,663,100,214,.467,23,67,.343,77,147,.524,.521,28,35,.800,9,58,67,78,24,9,39,60,251
241,Aaron Holiday\holidaa01,PG,25,PHO,17,0,290,44,94,.468,13,24,.542,31,70,.443,.537,22,23,.957,11,33,44,63,16,0,22,21,123
242,Jrue Holiday\holidjr01,PG,31,MIL,60,57,1988,438,866,.506,118,284,.415,320,582,.550,.574,124,163,.761,62,204,266,404,97,26,168,118,1118
243,Justin Holiday\holidju01,SF-SG,32,TOT,68,59,1940,247,628,.393,165,459,.359,82,169,.485,.525,50,62,.806,28,152,180,119,51,33,68,144,709
243,Justin Holiday\holidju01,SF,32,IND,49,40,1416,190,458,.415,127,336,.378,63,122,.516,.553,34,41,.829,18,117,135,90,36,18,49,105,541
243,Justin Holiday\holidju01,SG,32,SAC,19,19,524,57,170,.335,38,123,.309,19,47,.404,.447,16,21,.762,10,35,45,29,15,15,19,39,168
244,Richaun Holmes\holmeri01,C,28,SAC,45,37,1074,198,300,.660,2,5,.400,196,295,.664,.663,70,90,.778,93,224,317,48,17,41,56,128,468
245,Rodney Hood\hoodro01,SF-SG,29,TOT,48,0,661,54,151,.358,27,87,.310,27,64,.422,.447,15,17,.882,15,59,74,35,14,6,10,29,150
245,Rodney Hood\hoodro01,SF,29,MIL,39,0,581,46,131,.351,24,80,.300,22,51,.431,.443,13,14,.929,13,54,67,30,12,4,7,27,129
245,Rodney Hood\hoodro01,SG,29,LAC,9,0,80,8,20,.400,3,7,.429,5,13,.385,.475,2,3,.667,2,5,7,5,2,2,3,2,21
246,Scotty Hopson\hopsosc01,SG,32,OKC,1,0,18,2,4,.500,0,1,.000,2,3,.667,.500,0,0,,0,1,1,1,0,0,2,1,4
247,Al Horford\horfoal01,C,35,BOS,64,64,1853,240,531,.452,81,251,.323,159,280,.568,.528,77,92,.837,96,385,481,212,44,87,62,119,638
248,Talen Horton-Tucker\hortota01,SG,21,LAL,53,16,1348,188,456,.412,42,158,.266,146,298,.490,.458,77,100,.770,34,138,172,140,47,27,76,134,495
249,Danuel House Jr.\houseda01,SF,28,TOT,36,5,582,65,159,.409,35,91,.385,30,68,.441,.519,35,45,.778,15,78,93,41,14,13,25,40,200
249,Danuel House Jr.\houseda01,SF,28,HOU,16,1,233,25,74,.338,10,34,.294,15,40,.375,.405,17,19,.895,4,39,43,19,5,5,18,16,77
249,Danuel House Jr.\houseda01,SF,28,NYK,1,0,3,0,1,.000,0,1,.000,0,0,,.000,0,0,,0,0,0,0,0,0,0,0,0
249,Danuel House Jr.\houseda01,SF,28,UTA,19,4,346,40,84,.476,25,56,.446,15,28,.536,.625,18,26,.692,11,39,50,22,9,8,7,24,123
250,Dwight Howard\howardw01,C,36,LAL,53,20,822,107,177,.605,6,9,.667,101,168,.601,.621,76,117,.650,107,197,304,30,30,33,43,106,296
251,Markus Howard\howarma02,SG,22,DEN,29,0,149,31,82,.378,26,60,.433,5,22,.227,.537,13,15,.867,0,9,9,6,8,0,6,11,101
252,Kevin Huerter\huertke01,SG,23,ATL,67,53,1980,308,687,.448,140,369,.379,168,318,.528,.550,36,46,.783,31,198,229,185,46,25,84,167,792
253,Jay Huff\huffja01,C,23,LAL,4,0,20,0,3,.000,0,2,.000,0,1,.000,.000,0,0,,1,3,4,1,1,1,1,1,0
254,Elijah Hughes\hugheel01,SG-SF,23,TOT,31,4,360,40,120,.333,22,80,.275,18,40,.450,.425,5,7,.714,5,45,50,19,11,6,13,32,107
254,Elijah Hughes\hugheel01,SF,23,UTA,14,1,112,15,36,.417,10,28,.357,5,8,.625,.556,3,3,1.000,2,15,17,6,4,1,7,7,43
254,Elijah Hughes\hugheel01,SG,23,POR,17,3,248,25,84,.298,12,52,.231,13,32,.406,.369,2,4,.500,3,30,33,13,7,5,6,25,64
255,De'Andre Hunter\huntede01,SF,24,ATL,46,45,1378,222,495,.448,65,172,.378,157,323,.486,.514,107,142,.754,22,125,147,61,35,18,59,134,616
256,Chandler Hutchison\hutchch01,SF,25,PHO,6,0,22,1,2,.500,0,0,,1,2,.500,.500,2,2,1.000,0,5,5,2,0,0,4,1,4
257,Bones Hyland\hylanbo01,PG,21,DEN,63,3,1165,201,504,.399,119,314,.379,82,190,.432,.517,93,111,.838,12,160,172,156,36,15,78,137,614
258,Serge Ibaka\ibakase01,C-PF,32,TOT,51,11,835,140,283,.495,36,96,.375,104,187,.556,.558,32,44,.727,57,178,235,45,11,33,41,93,348
258,Serge Ibaka\ibakase01,C,32,LAC,35,10,538,94,192,.490,24,62,.387,70,130,.538,.552,20,29,.690,40,110,150,36,7,26,33,56,232
258,Serge Ibaka\ibakase01,PF,32,MIL,16,1,297,46,91,.505,12,34,.353,34,57,.596,.571,12,15,.800,17,68,85,9,4,7,8,37,116
259,Andre Iguodala\iguodan01,SF,38,GSW,27,0,534,42,105,.400,15,63,.238,27,42,.643,.471,14,18,.778,21,68,89,101,22,21,23,28,113
260,Joe Ingles\inglejo01,SF,34,UTA,45,15,1122,115,285,.404,78,225,.347,37,60,.617,.540,17,22,.773,12,119,131,158,23,5,46,82,325
261,Brandon Ingram\ingrabr01,SF,24,NOP,51,51,1738,431,928,.464,72,217,.332,359,711,.505,.503,232,284,.817,34,257,291,282,32,24,137,109,1166
262,Kyrie Irving\irvinky01,PG,29,BRK,22,22,800,217,452,.480,69,167,.413,148,285,.519,.556,94,104,.904,13,84,97,126,29,16,50,59,597
263,Wes Iwundu\iwundwe01,SF,27,ATL,3,1,82,8,18,.444,3,5,.600,5,13,.385,.528,3,4,.750,3,10,13,0,1,0,1,8,22
264,Frank Jackson\jacksfr01,PG,23,DET,46,5,1011,168,419,.401,78,247,.316,90,172,.523,.494,66,82,.805,15,57,72,44,24,9,36,78,480
265,Isaiah Jackson\jacksis01,PF,20,IND,31,12,414,91,165,.552,4,13,.308,87,152,.572,.564,47,72,.653,51,76,127,9,17,41,31,76,233
266,Jaren Jackson Jr.\jacksja02,PF,22,MEM,74,74,2017,412,986,.418,122,379,.322,290,607,.478,.480,267,326,.819,116,315,431,78,70,167,124,262,1213
267,Josh Jackson\jacksjo02,SF,24,TOT,45,3,726,104,260,.400,30,118,.254,74,142,.521,.458,42,58,.724,17,108,125,50,22,19,41,75,280
267,Josh Jackson\jacksjo02,SF,24,DET,39,3,707,103,251,.410,30,113,.265,73,138,.529,.470,40,56,.714,17,106,123,49,21,18,38,71,276
267,Josh Jackson\jacksjo02,SF,24,SAC,6,0,19,1,9,.111,0,5,.000,1,4,.250,.111,2,2,1.000,0,2,2,1,1,1,3,4,4
268,Justin Jackson\jacksju01,SF,26,TOT,7,0,37,5,15,.333,3,9,.333,2,6,.333,.433,2,2,1.000,1,6,7,2,0,0,1,3,15
268,Justin Jackson\jacksju01,SF,26,BOS,1,0,2,0,1,.000,0,0,,0,1,.000,.000,2,2,1.000,0,0,0,0,0,0,0,0,2
268,Justin Jackson\jacksju01,SF,26,PHO,6,0,35,5,14,.357,3,9,.333,2,5,.400,.464,0,0,,1,6,7,2,0,0,1,3,13
269,Reggie Jackson\jacksre01,SG,31,LAC,70,70,2174,447,1136,.393,157,475,.331,290,661,.439,.463,129,154,.838,38,221,259,334,52,12,160,143,1180
270,LeBron James\jamesle01,SF,37,LAL,55,55,2045,627,1198,.523,158,440,.359,469,758,.619,.589,245,324,.756,63,388,451,345,72,59,190,118,1657
271,DeJon Jarreau\jarrede01,SG,24,IND,1,0,1,0,0,,0,0,,0,0,,,0,0,,0,0,0,0,0,0,0,0,0
272,DaQuan Jeffries\jeffrda01,SG,24,MEM,3,0,9,1,2,.500,0,1,.000,1,1,1.000,.500,0,0,,0,2,2,1,0,0,0,1,2
273,Ty Jerome\jeromty01,SG,24,OKC,48,4,801,124,328,.378,54,186,.290,70,142,.493,.460,38,47,.809,19,59,78,109,30,5,37,73,340
274,Isaiah Joe\joeis01,SG,22,PHI,51,1,566,56,162,.346,40,124,.323,16,38,.421,.469,24,26,.923,6,44,50,33,12,3,16,43,176
275,Alize Johnson\johnsal02,PF,25,TOT,23,0,167,17,39,.436,0,4,.000,17,35,.486,.436,7,12,.583,28,33,61,9,5,0,12,18,41
275,Alize Johnson\johnsal02,PF,25,CHI,16,0,121,12,23,.522,0,2,.000,12,21,.571,.522,4,7,.571,16,20,36,8,3,0,8,15,28
275,Alize Johnson\johnsal02,PF,25,WAS,3,0,18,2,6,.333,0,2,.000,2,4,.500,.333,0,1,.000,5,7,12,0,0,0,3,0,4
275,Alize Johnson\johnsal02,PF,25,NOP,4,0,28,3,10,.300,0,0,,3,10,.300,.300,3,4,.750,7,6,13,1,2,0,1,3,9
276,B.J. Johnson\johnsbj01,SF,26,ORL,4,0,65,11,25,.440,4,10,.400,7,15,.467,.520,0,0,,6,9,15,0,0,1,0,4,26
277,Cameron Johnson\johnsca02,PF,25,PHO,60,13,1579,261,549,.475,159,355,.448,102,194,.526,.620,89,102,.873,36,210,246,89,50,14,36,102,770
278,David Johnson\johnsda08,SG,20,TOR,2,0,2,0,1,.000,0,1,.000,0,0,,.000,0,0,,0,0,0,0,0,0,0,0,0
279,Jalen Johnson\johnsja05,PF,20,ATL,19,0,111,22,39,.564,3,12,.250,19,27,.704,.603,5,7,.714,2,23,25,3,3,2,9,9,52
280,James Johnson\johnsja01,PF,34,BRK,59,10,1135,142,300,.473,23,83,.277,119,217,.548,.512,28,53,.528,49,156,205,123,29,31,46,154,335
281,Joe Johnson\johnsjo02,SG,40,BOS,1,0,2,1,1,1.000,0,0,,1,1,1.000,1.000,0,0,,0,0,0,0,0,0,0,0,2
282,Keldon Johnson\johnske04,SF,22,SAS,69,68,2189,424,911,.465,141,352,.401,283,559,.506,.543,153,203,.754,76,347,423,135,52,12,85,128,1142
283,Keon Johnson\johnske07,SG,19,TOT,30,5,492,63,188,.335,21,64,.328,42,124,.339,.391,32,40,.800,20,43,63,40,21,7,31,51,179
283,Keon Johnson\johnske07,SG,19,LAC,15,0,135,17,51,.333,3,11,.273,14,40,.350,.363,16,21,.762,6,15,21,13,7,2,7,21,53
283,Keon Johnson\johnske07,SG,19,POR,15,5,357,46,137,.336,18,53,.340,28,84,.333,.401,16,19,.842,14,28,42,27,14,5,24,30,126
284,Stanley Johnson\johnsst04,PF,25,LAL,40,22,871,95,198,.480,28,81,.346,67,117,.573,.551,31,43,.721,26,96,122,67,36,13,22,95,249
285,Tyler Johnson\johnsty01,PG,29,TOT,6,0,91,6,20,.300,5,13,.385,1,7,.143,.425,0,0,,3,9,12,7,3,3,2,7,17
285,Tyler Johnson\johnsty01,PG,29,PHI,3,0,38,4,10,.400,3,7,.429,1,3,.333,.550,0,0,,1,5,6,2,1,1,1,4,11
285,Tyler Johnson\johnsty01,PG,29,SAS,3,0,53,2,10,.200,2,6,.333,0,4,.000,.300,0,0,,2,4,6,5,2,2,1,3,6
286,Nikola Jokić\jokicni01,C,26,DEN,69,69,2288,686,1190,.576,95,275,.345,591,915,.646,.616,348,429,.811,192,744,936,551,98,59,258,178,1815
287,Carlik Jones\jonesca03,PG,24,TOT,5,0,23,1,9,.111,0,1,.000,1,8,.125,.111,2,2,1.000,1,2,3,5,1,0,3,0,4
287,Carlik Jones\jonesca03,PG,24,DAL,3,0,19,0,7,.000,0,1,.000,0,6,.000,.000,2,2,1.000,1,2,3,5,1,0,3,0,2
287,Carlik Jones\jonesca03,PG,24,DEN,2,0,4,1,2,.500,0,0,,1,2,.500,.500,0,0,,0,0,0,0,0,0,0,0,2
288,Damian Jones\jonesda03,C,26,SAC,50,9,830,134,208,.644,8,23,.348,126,185,.681,.663,67,94,.713,65,135,200,54,21,34,49,111,343
289,Derrick Jones Jr.\jonesde02,PF,24,CHI,46,8,805,94,173,.543,16,50,.320,78,123,.634,.590,48,61,.787,54,101,155,25,22,30,25,98,252
290,Herbert Jones\joneshe01,PF,23,NOP,72,63,2161,258,536,.481,53,153,.346,205,383,.535,.531,125,148,.845,89,188,277,155,118,54,96,224,694
291,Jemerrio Jones\jonesje01,SF,26,LAL,2,0,15,2,3,.667,0,0,,2,3,.667,.667,0,0,,2,1,3,0,1,0,0,2,4
292,Kai Jones\joneska01,C,21,CHO,19,0,58,8,13,.615,1,2,.500,7,11,.636,.654,3,8,.375,3,7,10,4,1,0,6,7,20
293,Mason Jones\jonesma05,SG,23,LAL,2,0,9,2,8,.250,0,2,.000,2,6,.333,.250,1,2,.500,1,1,2,0,1,0,1,1,5
294,Tre Jones\jonestr01,PG,22,SAS,62,6,948,132,274,.482,5,39,.128,127,235,.540,.491,54,69,.783,28,102,130,185,34,6,41,65,323
295,Tyus Jones\jonesty01,PG,25,MEM,69,20,1438,227,503,.451,70,187,.374,157,316,.497,.521,54,66,.818,16,151,167,301,62,2,43,31,578
296,DeAndre Jordan\jordade01,C,33,TOT,43,19,560,77,125,.616,0,0,,77,125,.616,.616,22,38,.579,77,160,237,18,12,31,34,65,176
296,DeAndre Jordan\jordade01,C,33,LAL,32,19,408,60,89,.674,0,0,,60,89,.674,.674,12,26,.462,51,121,172,13,10,26,21,50,132
296,DeAndre Jordan\jordade01,C,33,PHI,11,0,152,17,36,.472,0,0,,17,36,.472,.472,10,12,.833,26,39,65,5,2,5,13,15,44
297,Cory Joseph\josepco01,PG,30,DET,63,37,1558,175,387,.452,63,150,.420,112,237,.473,.534,95,108,.880,28,141,169,234,40,17,83,146,508
298,Georgios Kalaitzakis\kalaige01,SF,23,MIL,9,0,48,5,11,.455,2,4,.500,3,7,.429,.545,4,9,.444,4,4,8,0,1,1,4,8,16
299,Frank Kaminsky\kaminfr01,C,28,PHO,9,0,181,36,66,.545,5,15,.333,31,51,.608,.583,18,20,.900,11,30,41,13,8,7,5,14,95
300,Luke Kennard\kennalu01,SG,25,LAC,64,11,1757,254,574,.443,171,382,.448,83,192,.432,.591,59,66,.894,16,195,211,134,37,6,56,96,738
301,Braxton Key\keybr01,SF,24,TOT,4,0,38,7,15,.467,1,3,.333,6,12,.500,.500,0,0,,3,6,9,1,3,3,4,7,15
301,Braxton Key\keybr01,SF,24,PHI,2,0,6,1,2,.500,0,1,.000,1,1,1.000,.500,0,0,,1,1,2,1,1,0,2,1,2
301,Braxton Key\keybr01,SF,24,DET,2,0,32,6,13,.462,1,2,.500,5,11,.455,.500,0,0,,2,5,7,0,2,3,2,6,13
302,George King\kingge03,SF,28,DAL,4,0,19,0,5,.000,0,4,.000,0,1,.000,.000,1,2,.500,0,5,5,0,0,0,1,4,1
303,Louis King\kinglo02,SF,22,SAC,10,0,104,15,47,.319,8,27,.296,7,20,.350,.404,7,10,.700,0,12,12,9,2,1,0,14,45
304,Corey Kispert\kispeco01,SF,22,WAS,69,28,1547,201,443,.454,96,273,.352,105,170,.618,.562,46,54,.852,51,128,179,72,28,22,44,78,544
305,Maxi Kleber\klebima01,PF,30,DAL,56,21,1382,135,337,.401,78,239,.326,57,98,.582,.516,46,65,.708,68,264,332,66,28,56,43,132,394
306,Brandon Knight\knighbr03,PG,30,DAL,3,0,54,9,20,.450,4,13,.308,5,7,.714,.550,8,8,1.000,0,7,7,8,1,0,4,5,30
307,Nathan Knight\knighna01,PF,24,MIN,36,2,251,38,76,.500,3,10,.300,35,66,.530,.520,42,57,.737,30,47,77,19,7,8,17,38,121
308,Kevin Knox\knoxke01,SF,22,TOT,26,0,194,22,68,.324,11,43,.256,11,25,.440,.404,13,18,.722,13,26,39,10,3,1,7,13,68
308,Kevin Knox\knoxke01,SF,22,NYK,13,0,111,15,40,.375,10,28,.357,5,12,.417,.500,7,10,.700,8,14,22,3,2,1,5,5,47
308,Kevin Knox\knoxke01,SF,22,ATL,13,0,83,7,28,.250,1,15,.067,6,13,.462,.268,6,8,.750,5,12,17,7,1,0,2,8,21
309,John Konchar\konchjo01,SG,25,MEM,66,6,1179,119,234,.509,47,116,.405,72,118,.610,.609,25,44,.568,71,229,300,92,42,21,26,81,310
310,Furkan Korkmaz\korkmfu01,SG,24,PHI,61,19,1354,179,451,.397,76,254,.299,103,197,.523,.481,62,78,.795,20,151,171,122,32,7,46,54,496
311,Luke Kornet\kornelu01,C,26,TOT,11,0,59,6,17,.353,0,3,.000,6,14,.429,.353,2,4,.500,8,7,15,4,2,1,0,5,14
311,Luke Kornet\kornelu01,C,26,CLE,2,0,15,1,5,.200,0,1,.000,1,4,.250,.200,2,3,.667,2,1,3,1,0,1,0,1,4
311,Luke Kornet\kornelu01,C,26,MIL,1,0,3,0,1,.000,0,0,,0,1,.000,.000,0,0,,1,0,1,0,0,0,0,1,0
311,Luke Kornet\kornelu01,C,26,BOS,8,0,41,5,11,.455,0,2,.000,5,9,.556,.455,0,1,.000,5,6,11,3,2,0,0,3,10
312,Vit Krejci\krejcvi01,SG,21,OKC,23,1,438,42,91,.462,26,62,.419,16,29,.552,.604,8,9,.889,11,54,65,30,12,5,17,41,118
313,Arnoldas Kulboka\kulboar01,SF,24,CHO,1,0,3,0,0,,0,0,,0,0,,,0,0,,0,0,0,0,0,0,0,0,0
314,Jonathan Kuminga\kuminjo01,SF,19,GSW,64,12,1085,215,427,.504,43,140,.307,172,287,.599,.554,120,176,.682,50,166,216,56,26,20,69,133,593
315,Kyle Kuzma\kuzmaky01,PF,26,WAS,66,66,2204,423,936,.452,128,375,.341,295,561,.526,.520,156,219,.712,70,491,561,233,42,57,169,128,1130
316,Anthony Lamb\lamban01,SF,24,SAS,2,0,8,0,2,.000,0,2,.000,0,0,,.000,0,0,,0,1,1,2,0,0,0,0,0
317,Jeremy Lamb\lambje01,SF-SG,29,TOT,50,0,820,116,308,.377,51,153,.333,65,155,.419,.459,80,96,.833,22,114,136,70,27,21,31,52,363
317,Jeremy Lamb\lambje01,SF,29,IND,39,0,613,85,228,.373,39,117,.333,46,111,.414,.458,67,80,.838,15,79,94,51,23,14,24,44,276
317,Jeremy Lamb\lambje01,SG,29,SAC,11,0,207,31,80,.388,12,36,.333,19,44,.432,.463,13,16,.813,7,35,42,19,4,7,7,8,87
318,Jock Landale\landajo01,C,26,SAS,49,1,532,95,188,.505,26,81,.321,69,107,.645,.574,29,34,.853,57,63,120,43,10,13,29,49,245
319,Romeo Langford\langfro01,SG,22,TOT,45,5,744,82,188,.436,29,84,.345,53,104,.510,.513,21,38,.553,30,75,105,19,21,16,16,46,214
319,Romeo Langford\langfro01,SG,22,BOS,44,5,728,79,184,.429,29,83,.349,50,101,.495,.508,20,34,.588,30,74,104,19,21,16,16,46,207
319,Romeo Langford\langfro01,SG,22,SAS,1,0,16,3,4,.750,0,1,.000,3,3,1.000,.750,1,4,.250,0,1,1,0,0,0,0,0,7
320,Zach LaVine\lavinza01,SF,26,CHI,62,62,2161,534,1114,.479,175,443,.395,359,671,.535,.558,294,344,.855,20,269,289,284,39,22,162,109,1537
321,Jake Layman\laymaja01,SF,27,MIN,32,1,209,25,65,.385,6,31,.194,19,34,.559,.431,9,12,.750,6,26,32,9,6,5,9,12,65
322,Damion Lee\leeda03,SG,29,GSW,59,4,1180,158,359,.440,62,181,.343,96,178,.539,.526,61,70,.871,24,165,189,58,38,5,36,91,439
323,Saben Lee\leesa01,PG,22,DET,34,0,519,60,155,.387,13,52,.250,47,103,.456,.429,42,53,.792,13,63,76,83,32,11,27,37,175
324,Alex Len\lenal01,C,28,SAC,37,10,613,93,174,.534,6,21,.286,87,153,.569,.552,41,63,.651,51,109,160,45,13,25,43,97,233
325,Caris LeVert\leverca01,SG,27,TOT,51,42,1551,338,771,.438,74,232,.319,264,539,.490,.486,125,168,.744,38,148,186,216,44,21,95,116,875
325,Caris LeVert\leverca01,SG,27,IND,39,39,1214,278,622,.447,61,189,.323,217,433,.501,.496,111,146,.760,30,120,150,173,35,18,75,91,728
325,Caris LeVert\leverca01,SG,27,CLE,12,3,337,60,149,.403,13,43,.302,47,106,.443,.446,14,22,.636,8,28,36,43,9,3,20,25,147
326,Kira Lewis Jr.\lewiski01,PG,20,NOP,24,0,341,59,146,.404,13,58,.224,46,88,.523,.449,10,12,.833,9,30,39,49,11,1,26,17,141
327,Scottie Lewis\lewissc01,SG,21,CHO,2,0,7,0,0,,0,0,,0,0,,,1,2,.500,0,0,0,1,1,0,0,0,1
328,Damian Lillard\lillada01,PG,31,POR,29,29,1056,222,552,.402,92,284,.324,130,268,.485,.486,159,181,.878,13,107,120,212,17,11,83,37,695
329,Nassir Little\littlna01,SF,21,POR,42,23,1088,145,315,.460,51,154,.331,94,161,.584,.541,69,94,.734,58,178,236,54,25,36,40,82,410
330,Isaiah Livers\liveris01,SF,23,DET,13,0,215,22,55,.400,15,42,.357,7,13,.538,.536,4,5,.800,10,22,32,11,7,5,8,25,63
331,Kevon Looney\looneke01,C,25,GSW,76,74,1648,199,349,.570,0,1,.000,199,348,.572,.570,75,125,.600,201,370,571,155,48,52,65,207,473
332,Brook Lopez\lopezbr01,C,33,MIL,7,5,152,24,56,.429,8,25,.320,16,31,.516,.500,9,11,.818,11,15,26,6,4,9,6,22,65
333,Robin Lopez\lopezro01,C,33,ORL,30,9,523,98,174,.563,2,5,.400,96,169,.568,.569,25,43,.581,61,49,110,46,1,16,39,61,223
334,Didi Louzada\louzama01,SF,22,NOP,2,0,7,0,3,.000,0,3,.000,0,0,,.000,0,0,,2,0,2,1,0,0,0,0,0
335,Kevin Love\loveke01,PF,33,CLE,67,4,1510,291,685,.425,164,425,.386,127,260,.488,.545,159,188,.846,77,410,487,146,24,16,89,86,905
336,Kyle Lowry\lowryky01,PG,35,MIA,59,59,2004,251,582,.431,132,358,.369,119,224,.531,.545,136,159,.855,31,238,269,443,64,17,161,162,770
337,Timothé Luwawu-Cabarrot\luwawti01,SF,26,ATL,46,14,568,61,157,.389,39,107,.364,22,50,.440,.513,26,30,.867,13,53,66,31,16,5,18,62,187
338,Trey Lyles\lylestr01,PF,26,TOT,69,17,1395,238,510,.467,61,192,.318,177,318,.557,.526,172,215,.800,84,267,351,81,26,31,69,117,709
338,Trey Lyles\lylestr01,PF,26,DET,51,3,990,175,384,.456,44,146,.301,131,238,.550,.513,138,176,.784,60,184,244,58,22,26,54,91,532
338,Trey Lyles\lylestr01,PF,26,SAC,18,14,405,63,126,.500,17,46,.370,46,80,.575,.567,34,39,.872,24,83,107,23,4,5,15,26,177
339,Théo Maledon\maledth01,PG,20,OKC,48,4,810,98,272,.360,39,136,.287,59,136,.434,.432,71,90,.789,18,99,117,92,28,9,56,59,306
340,Sandro Mamukelashvili\mamuksa01,PF,22,MIL,37,2,331,42,88,.477,18,42,.429,24,46,.522,.580,11,14,.786,29,36,65,16,7,7,10,24,113
341,Terance Mann\mannte01,SF,25,LAC,74,31,2147,306,638,.480,71,196,.362,235,442,.532,.535,119,152,.783,98,306,404,189,55,16,76,166,802
342,Tre Mann\manntr01,PG,20,OKC,60,26,1367,231,588,.393,98,272,.360,133,316,.421,.476,65,82,.793,25,146,171,91,47,12,71,102,625
343,Boban Marjanović\marjabo01,C,33,DAL,20,0,106,37,60,.617,1,3,.333,36,57,.632,.625,11,20,.550,7,24,31,2,0,3,11,20,86
344,Lauri Markkanen\markkla01,PF,24,CLE,54,54,1682,276,627,.440,117,337,.347,159,290,.548,.533,119,139,.856,55,249,304,76,44,27,49,106,788
345,Naji Marshall\marshna01,SF,24,NOP,48,3,621,93,233,.399,21,97,.216,72,136,.529,.444,54,71,.761,34,94,128,48,30,5,37,57,261
346,Caleb Martin\martica02,SF,26,MIA,57,10,1293,199,389,.512,60,145,.414,139,244,.570,.589,69,90,.767,69,151,220,62,56,26,47,99,527
347,Cody Martin\martico01,SF,26,CHO,65,11,1714,184,393,.468,58,148,.392,126,245,.514,.542,72,104,.692,75,187,262,160,80,30,59,110,498
348,Kelan Martin\martike03,SF,26,TOT,30,1,450,70,171,.409,22,75,.293,48,96,.500,.474,9,13,.692,17,38,55,21,13,9,14,36,171
348,Kelan Martin\martike03,SF,26,IND,27,1,444,70,168,.417,22,74,.297,48,94,.511,.482,9,13,.692,16,37,53,21,13,9,14,36,171
348,Kelan Martin\martike03,SF,26,BOS,3,0,6,0,3,.000,0,1,.000,0,2,.000,.000,0,0,,1,1,2,0,0,0,0,0,0
349,Kenyon Martin Jr.\martike04,SF,21,HOU,73,2,1524,261,484,.539,55,149,.369,206,335,.615,.596,71,114,.623,75,205,280,96,32,35,56,99,648
350,Garrison Mathews\mathega01,SG,25,HOU,59,27,1543,167,419,.399,125,349,.358,42,70,.600,.548,132,165,.800,29,141,170,58,51,19,36,149,591
351,Dakota Mathias\mathida01,SG,26,MEM,6,0,16,2,6,.333,2,6,.333,0,0,,.500,0,0,,0,2,2,1,1,0,0,1,6
352,Wesley Matthews\matthwe02,SG,35,MIL,43,8,852,72,188,.383,45,136,.331,27,52,.519,.503,15,21,.714,25,57,82,32,21,6,16,75,204
353,Tyrese Maxey\maxeyty01,PG,21,PHI,67,66,2385,432,898,.481,111,267,.416,321,631,.509,.543,191,223,.857,25,201,226,287,48,30,76,141,1166
354,Skylar Mays\mayssk01,SG,24,ATL,25,5,211,32,62,.516,8,25,.320,24,37,.649,.581,8,9,.889,5,20,25,16,7,0,10,8,80
355,Miles McBride\mcbrimi01,PG,21,NYK,36,2,327,27,93,.290,13,56,.232,14,37,.378,.360,8,12,.667,4,35,39,40,13,1,5,42,75
356,Mac McClung\mccluma01,PG,23,CHI,1,0,3,1,1,1.000,0,0,,1,1,1.000,1.000,0,0,,0,0,0,0,0,0,1,0,2
357,CJ McCollum\mccolcj01,SG,30,TOT,55,55,1936,483,1050,.460,164,427,.384,319,623,.512,.538,102,143,.713,49,197,246,286,58,22,111,111,1232
357,CJ McCollum\mccolcj01,SG,30,POR,36,36,1267,290,665,.436,111,289,.384,179,376,.476,.520,48,68,.706,34,119,153,163,36,21,70,77,739
357,CJ McCollum\mccolcj01,SG,30,NOP,19,19,669,193,385,.501,53,138,.384,140,247,.567,.570,54,75,.720,15,78,93,123,22,1,41,34,493
358,T.J. McConnell\mccontj01,PG,29,IND,24,6,581,91,181,.503,7,25,.280,84,156,.538,.522,12,15,.800,19,61,80,115,25,9,28,43,201
359,Jaden McDaniels\mcdanja02,PF,21,MIN,67,31,1749,248,540,.459,77,246,.313,171,294,.582,.531,56,70,.800,76,211,287,77,51,52,73,220,629
360,Jalen McDaniels\mcdanja01,SF,24,CHO,49,2,809,104,224,.464,33,96,.344,71,128,.555,.538,45,64,.703,34,120,154,48,21,18,34,84,286
361,Doug McDermott\mcderdo01,PF,30,SAS,51,51,1223,215,465,.462,108,256,.422,107,209,.512,.578,40,51,.784,18,97,115,64,13,6,43,79,578
362,JaVale McGee\mcgeeja01,C,34,PHO,68,14,1056,267,418,.639,2,8,.250,265,410,.646,.641,96,135,.711,148,298,446,39,19,75,86,169,632
363,Cameron McGriff\mcgrica01,SF,24,POR,3,0,46,5,14,.357,2,6,.333,3,8,.375,.429,2,2,1.000,6,9,15,3,0,1,0,7,14
364,Rodney McGruder\mcgruro01,SG,30,DET,47,2,668,80,192,.417,49,128,.383,31,64,.484,.544,14,20,.700,29,69,98,43,19,5,21,49,223
365,Alfonzo McKinnie\mckinal01,SF,29,CHI,17,3,206,24,61,.393,9,27,.333,15,34,.441,.467,2,8,.250,13,20,33,5,2,3,7,26,59
366,JaQuori McLaughlin\mclauja01,PG,24,DAL,4,0,11,0,2,.000,0,1,.000,0,1,.000,.000,0,0,,0,0,0,2,0,0,0,1,0
367,Jordan McLaughlin\mclaujo01,PG,25,MIN,56,3,783,75,180,.417,18,71,.254,57,109,.523,.467,27,37,.730,17,67,84,161,52,7,32,45,195
368,Ben McLemore\mclembe01,SG,28,POR,57,6,1107,183,469,.390,131,364,.360,52,105,.495,.530,58,71,.817,12,79,91,48,28,10,44,90,555
369,De'Anthony Melton\meltode01,SG,23,MEM,67,13,1504,256,631,.406,124,333,.372,132,298,.443,.504,74,102,.725,59,241,300,176,101,34,101,116,710
370,Sam Merrill\merrisa01,SG,25,MEM,6,0,58,8,24,.333,7,23,.304,1,1,1.000,.479,2,4,.500,1,6,7,4,0,0,2,3,25
371,Chimezie Metu\metuch01,C,24,SAC,54,20,1134,177,399,.444,51,172,.297,126,227,.555,.508,65,83,.783,32,262,294,57,44,28,55,82,470
372,Khris Middleton\middlkh01,SF,30,MIL,60,60,1940,414,930,.445,148,390,.379,266,540,.493,.525,244,273,.894,38,283,321,323,66,15,174,144,1220
373,C.J. Miles\milescj01,SG,34,BOS,1,0,2,0,0,,0,0,,0,0,,,0,0,,0,0,0,0,0,0,0,1,0
374,Patty Mills\millspa02,PG,33,BRK,74,46,2179,310,757,.410,214,535,.400,96,222,.432,.551,46,56,.821,18,130,148,172,48,17,66,103,880
375,Paul Millsap\millspa01,PF,36,TOT,32,1,366,45,114,.395,8,35,.229,37,79,.468,.430,17,24,.708,41,73,114,29,9,13,18,65,115
375,Paul Millsap\millspa01,PF,36,BRK,24,0,270,32,85,.376,6,27,.222,26,58,.448,.412,12,17,.706,29,60,89,24,5,11,11,48,82
375,Paul Millsap\millspa01,PF,36,PHI,8,1,96,13,29,.448,2,8,.250,11,21,.524,.483,5,7,.714,12,13,25,5,4,2,7,17,33
376,Shake Milton\miltosh01,PG,25,PHI,47,6,1010,145,351,.413,33,113,.292,112,238,.471,.460,51,60,.850,26,99,125,117,24,15,42,84,374
377,Davion Mitchell\mitchda01,PG,23,SAC,69,13,1841,313,751,.417,97,300,.323,216,451,.479,.481,39,63,.619,32,121,153,247,52,20,93,127,762
378,Donovan Mitchell\mitchdo01,SG,25,UTA,62,62,2089,573,1269,.452,222,617,.360,351,652,.538,.539,239,279,.857,51,209,260,332,93,12,190,156,1607
379,Evan Mobley\mobleev01,PF,20,CLE,67,67,2274,408,806,.506,23,91,.253,385,715,.538,.520,160,241,.664,136,417,553,170,54,109,132,145,999
380,Malik Monk\monkma01,SG,23,LAL,68,30,1882,336,716,.469,150,388,.387,186,328,.567,.574,76,97,.784,31,191,222,184,55,25,98,122,898
381,Greg Monroe\monrogr01,C,31,TOT,10,0,151,24,44,.545,0,0,,24,44,.545,.545,7,14,.500,23,29,52,14,6,7,9,16,55
381,Greg Monroe\monrogr01,C,31,MIN,3,0,63,9,14,.643,0,0,,9,14,.643,.643,2,5,.400,5,16,21,11,2,4,4,7,20
381,Greg Monroe\monrogr01,C,31,WAS,2,0,18,4,8,.500,0,0,,4,8,.500,.500,0,0,,7,3,10,1,1,1,2,2,8
381,Greg Monroe\monrogr01,C,31,MIL,5,0,70,11,22,.500,0,0,,11,22,.500,.500,5,9,.556,11,10,21,2,3,2,3,7,27
382,Moses Moody\moodymo01,SG,19,GSW,48,10,583,76,178,.427,37,107,.346,39,71,.549,.531,28,36,.778,17,61,78,21,7,10,13,41,217
383,Xavier Moon\moonxa01,SG,27,LAC,6,0,83,14,34,.412,3,10,.300,11,24,.458,.456,2,3,.667,1,8,9,10,5,1,3,4,33
384,Matt Mooney\moonema01,SG,24,NYK,1,0,2,0,1,.000,0,1,.000,0,0,,.000,0,0,,0,0,0,0,1,0,1,0,0
385,Ja Morant\moranja01,PG,22,MEM,56,56,1862,573,1163,.493,86,253,.340,487,910,.535,.530,311,408,.762,75,246,321,375,66,21,192,84,1543
386,Juwan Morgan\morgaju01,PF,24,TOR,1,0,27,2,3,.667,1,2,.500,1,1,1.000,.833,0,0,,2,2,4,1,0,0,0,3,5
387,Jaylen Morris\morrija01,SG,26,SAS,3,0,16,0,6,.000,0,2,.000,0,4,.000,.000,2,4,.500,0,2,2,2,0,0,1,2,2
388,Marcus Morris\morrima03,PF,32,LAC,49,49,1421,278,640,.434,93,250,.372,185,390,.474,.507,118,135,.874,26,195,221,105,25,15,63,105,767
389,Markieff Morris\morrima02,PF,32,MIA,16,0,273,50,104,.481,11,33,.333,39,71,.549,.534,8,9,.889,16,26,42,19,3,1,20,32,119
390,Monte Morris\morrimo01,PG,26,DEN,70,69,2087,354,727,.487,117,294,.398,237,433,.547,.567,66,77,.857,22,186,208,305,50,13,71,83,891
391,Emmanuel Mudiay\mudiaem01,PG,25,SAC,2,0,11,0,2,.000,0,0,,0,2,.000,.000,3,4,.750,0,0,0,4,1,0,1,1,3
392,Mychal Mulder\muldemy01,PG,27,ORL,15,2,195,20,67,.299,13,46,.283,7,21,.333,.396,2,2,1.000,2,19,21,3,4,1,8,12,55
393,Ade Murkey\murkead01,SG,24,SAC,1,0,1,0,0,,0,0,,0,0,,,0,0,,0,0,0,0,0,0,0,0,0
394,Trey Murphy III\murphtr02,SF,21,NOP,55,0,731,88,225,.391,58,152,.382,30,73,.411,.520,34,40,.850,39,83,122,36,19,7,12,55,268
395,Dejounte Murray\murrade01,PG,25,SAS,66,66,2296,556,1206,.461,89,279,.319,467,927,.504,.498,187,238,.786,78,471,549,617,136,23,173,134,1388
396,Mike Muscala\muscami01,C,30,OKC,43,0,592,113,248,.456,70,163,.429,43,85,.506,.597,48,57,.842,21,108,129,22,18,26,14,58,344
397,Svi Mykhailiuk\mykhasv01,SF,24,TOR,54,5,704,89,227,.392,39,128,.305,50,99,.505,.478,32,37,.865,20,72,92,45,24,4,30,52,249
398,Abdel Nader\naderab01,SF,28,PHO,14,0,145,12,35,.343,4,14,.286,8,21,.381,.400,6,10,.600,4,23,27,7,8,4,11,20,34
399,Larry Nance Jr.\nancela02,PF,29,TOT,39,11,895,107,207,.517,20,63,.317,87,144,.604,.565,34,51,.667,60,160,220,74,38,17,28,70,268
399,Larry Nance Jr.\nancela02,PF,29,POR,37,11,858,102,198,.515,19,62,.306,83,136,.610,.563,32,49,.653,58,151,209,73,38,13,27,67,255
399,Larry Nance Jr.\nancela02,PF,29,NOP,2,0,37,5,9,.556,1,1,1.000,4,8,.500,.611,2,2,1.000,2,9,11,1,0,4,1,3,13
400,RJ Nembhard Jr.\nembhrj01,SG,22,CLE,12,0,57,6,16,.375,0,2,.000,6,14,.429,.375,3,4,.750,2,3,5,11,0,0,2,2,15
401,Aaron Nesmith\nesmiaa01,SF,22,BOS,48,3,533,64,166,.386,25,101,.248,39,65,.600,.461,19,24,.792,15,70,85,20,18,5,26,62,172
402,Raul Neto\netora01,PG,29,WAS,63,19,1312,193,423,.456,33,114,.289,160,309,.518,.495,77,101,.762,13,118,131,211,52,3,73,100,496
403,Malik Newman\newmama01,PG,24,CLE,1,0,8,3,5,.600,0,1,.000,3,4,.750,.600,2,2,1.000,0,1,1,1,0,0,1,0,8
404,Georges Niang\niangge01,PF,28,PHI,70,7,1622,230,531,.433,143,359,.398,87,172,.506,.568,49,56,.875,23,169,192,100,27,13,54,180,652
405,Daishen Nix\nixda01,SG,19,HOU,19,0,195,22,48,.458,7,18,.389,15,30,.500,.531,13,21,.619,5,22,27,31,13,0,18,14,64
406,Zeke Nnaji\nnajize01,PF,21,DEN,40,1,671,95,177,.537,37,76,.487,58,101,.574,.641,38,62,.613,55,90,145,15,16,13,22,76,265
407,Nerlens Noel\noelne01,C,27,NYK,25,11,562,32,60,.533,0,3,.000,32,57,.561,.533,21,30,.700,48,93,141,23,30,31,20,67,85
408,Jaylen Nowell\nowelja01,SG,22,MIN,57,1,891,180,375,.480,54,140,.386,126,235,.536,.552,62,79,.785,21,94,115,121,24,7,30,67,476
409,Frank Ntilikina\ntilila01,PG,23,DAL,55,5,674,87,219,.397,38,110,.345,49,109,.450,.484,24,25,.960,12,66,78,69,27,7,31,60,236
410,Jusuf Nurkić\nurkiju01,C,27,POR,56,56,1579,321,600,.535,15,56,.268,306,544,.563,.548,185,268,.690,167,452,619,157,62,34,143,189,842
411,David Nwaba\nwabada01,SF,29,HOU,45,4,596,84,174,.483,15,48,.313,69,126,.548,.526,48,67,.716,40,109,149,34,27,19,21,55,231
412,Jordan Nwora\nworajo01,SF,23,MIL,58,11,1091,169,419,.403,73,212,.344,96,207,.464,.490,21,26,.808,34,170,204,55,25,15,51,73,432
413,Royce O'Neale\onealro01,SF,28,UTA,71,71,2233,196,410,.478,115,283,.406,81,127,.638,.618,42,52,.808,57,290,347,178,85,32,69,169,549
414,Semi Ojeleye\ojelese01,PF,27,TOT,30,0,406,30,99,.303,15,50,.300,15,49,.306,.379,23,29,.793,27,47,74,9,7,6,9,30,98
414,Semi Ojeleye\ojelese01,PF,27,MIL,20,0,308,18,70,.257,11,41,.268,7,29,.241,.336,10,13,.769,25,33,58,5,5,5,5,26,57
414,Semi Ojeleye\ojelese01,PF,27,LAC,10,0,98,12,29,.414,4,9,.444,8,20,.400,.483,13,16,.813,2,14,16,4,2,1,4,4,41
415,Chuma Okeke\okekech01,PF,23,ORL,64,14,1578,194,516,.376,101,323,.313,93,193,.482,.474,52,61,.852,43,267,310,109,88,38,53,86,541
416,Josh Okogie\okogijo01,SG,23,MIN,45,6,468,34,92,.370,14,45,.311,20,47,.426,.446,27,41,.659,26,41,67,21,21,10,21,46,109
417,Onyeka Okongwu\okongon01,C,21,ATL,41,6,841,138,199,.693,0,0,,138,199,.693,.693,68,94,.723,99,129,228,43,25,55,40,130,344
418,Isaac Okoro\okorois01,SF,21,CLE,60,54,1787,192,403,.476,53,149,.356,139,254,.547,.542,112,141,.794,66,121,187,109,51,19,57,150,549
419,KZ Okpala\okpalkz01,PF,22,MIA,21,0,244,30,69,.435,9,26,.346,21,43,.488,.500,8,11,.727,11,30,41,14,4,7,5,25,77
420,Victor Oladipo\oladivi01,SG,29,MIA,6,0,110,15,40,.375,4,16,.250,11,24,.458,.425,4,6,.667,1,9,10,17,1,1,7,9,38
421,Cameron Oliver\oliveca01,SF,25,ATL,2,0,43,10,15,.667,1,3,.333,9,12,.750,.700,2,3,.667,2,4,6,3,1,1,0,5,23
422,Kelly Olynyk\olynyke01,C,30,DET,36,1,685,114,263,.433,37,111,.333,77,152,.507,.504,56,74,.757,50,112,162,94,27,16,52,92,321
423,Eugene Omoruyi\omorueu01,SF,24,DAL,4,0,18,2,5,.400,1,2,.500,1,3,.333,.500,2,4,.500,2,5,7,2,0,0,0,2,7
424,Miye Oni\onimi01,SG,24,UTA,16,0,44,2,9,.222,1,8,.125,1,1,1.000,.278,0,1,.000,1,6,7,5,0,0,1,7,5
425,Cedi Osman\osmande01,SF,26,CLE,60,3,1341,224,531,.422,116,332,.349,108,199,.543,.531,76,116,.655,22,106,128,121,50,8,60,113,640
426,Daniel Oturu\oturuda01,C,22,TOR,3,0,27,3,6,.500,0,1,.000,3,5,.600,.500,3,5,.600,1,4,5,0,0,2,0,1,9
427,Kelly Oubre Jr.\oubreke01,SF,26,CHO,70,13,1874,383,882,.434,178,520,.342,205,362,.566,.535,115,174,.661,76,204,280,78,74,30,66,177,1059
428,Jaysean Paige\paigeja01,PG,27,DET,1,0,7,0,3,.000,0,2,.000,0,1,.000,.000,0,0,,0,1,1,1,0,0,1,2,0
429,Trayvon Palmer\palmetr01,SG,27,DET,1,0,17,0,1,.000,0,0,,0,1,.000,.000,0,0,,0,2,2,0,0,0,1,2,0
430,Kevin Pangos\pangoke01,PG,29,CLE,24,3,166,15,46,.326,6,26,.231,9,20,.450,.391,3,4,.750,2,9,11,30,3,0,7,11,39
431,Jabari Parker\parkeja01,PF,26,BOS,12,0,112,18,38,.474,8,16,.500,10,22,.455,.579,9,9,1.000,5,23,28,6,4,1,8,13,53
432,Eric Paschall\pascher01,PF,25,UTA,54,3,717,109,226,.482,40,107,.374,69,119,.580,.571,64,83,.771,29,73,102,36,9,5,27,51,322
433,Chris Paul\paulch01,PG,36,PHO,60,60,1982,340,692,.491,62,188,.330,278,504,.552,.536,160,189,.847,17,250,267,646,110,20,142,119,902
434,Cameron Payne\payneca01,PG,27,PHO,53,11,1184,223,545,.409,66,194,.340,157,351,.447,.470,75,89,.843,21,135,156,256,35,16,94,110,587
435,Elfrid Payton\paytoel01,PG,27,PHO,47,1,514,61,159,.384,4,16,.250,57,143,.399,.396,12,30,.400,21,64,85,94,24,6,45,36,138
436,Gary Payton II\paytoga02,PG,29,GSW,65,15,1120,191,308,.620,41,111,.369,150,197,.761,.687,33,56,.589,66,159,225,55,88,20,37,119,456
437,Norvel Pelle\pelleno01,C,28,UTA,3,0,19,3,5,.600,0,0,,3,5,.600,.600,0,0,,3,3,6,0,0,1,2,1,6
438,Reggie Perry\perryre01,PF,21,TOT,3,0,51,5,10,.500,1,2,.500,4,8,.500,.550,2,2,1.000,2,6,8,2,1,0,1,9,13
438,Reggie Perry\perryre01,PF,21,POR,2,0,41,4,9,.444,1,2,.500,3,7,.429,.500,2,2,1.000,2,5,7,2,1,0,1,6,11
438,Reggie Perry\perryre01,PF,21,IND,1,0,10,1,1,1.000,0,0,,1,1,1.000,1.000,0,0,,0,1,1,0,0,0,0,3,2
439,Jamorko Pickett\pickeja01,PF,24,DET,10,0,94,8,26,.308,5,18,.278,3,8,.375,.404,0,0,,4,12,16,3,0,3,3,9,21
440,Theo Pinson\pinsoth01,SF,26,DAL,16,0,120,9,32,.281,6,25,.240,3,7,.429,.375,4,4,1.000,1,18,19,13,4,2,2,9,28
441,Mason Plumlee\plumlma01,C,31,CHO,67,67,1673,187,295,.634,0,2,.000,187,293,.638,.634,62,159,.390,167,368,535,211,57,48,89,208,436
442,Jakob Poeltl\poeltja01,C,26,SAS,63,62,1830,382,618,.618,1,1,1.000,381,617,.618,.619,87,177,.492,252,334,586,175,43,113,102,199,852
443,Aleksej Pokusevski\pokusal01,PF,20,OKC,59,10,1168,175,431,.406,50,184,.272,125,247,.506,.464,34,48,.708,72,232,304,111,38,37,85,82,434
444,Yves Pons\ponsyv01,SF,22,MEM,9,0,32,2,5,.400,1,2,.500,1,3,.333,.500,0,2,.000,3,3,6,0,0,0,0,2,5
445,Jordan Poole\poolejo01,SG,22,GSW,70,45,2080,428,949,.451,186,513,.363,242,436,.555,.549,213,232,.918,29,197,226,263,58,19,165,185,1255
446,Kevin Porter Jr.\porteke02,PG,21,HOU,55,55,1675,272,680,.400,127,346,.367,145,334,.434,.493,103,168,.613,36,189,225,331,60,20,172,140,774
447,Michael Porter Jr.\portemi01,SF,23,DEN,9,9,265,37,103,.359,10,48,.208,27,55,.491,.408,5,9,.556,9,50,59,17,10,2,12,16,89
448,Otto Porter Jr.\porteot01,PF,28,GSW,59,15,1282,184,391,.471,76,205,.371,108,186,.581,.568,48,59,.814,79,255,334,92,65,28,34,80,492
449,Bobby Portis\portibo01,C,26,MIL,65,58,1860,376,792,.475,124,311,.399,252,481,.524,.553,84,112,.750,165,431,596,78,48,51,86,161,960
450,Kristaps Porziņģis\porzikr01,PF,26,TOT,45,45,1308,303,669,.453,64,223,.287,239,446,.536,.501,219,252,.869,88,263,351,101,34,75,72,124,889
450,Kristaps Porziņģis\porzikr01,PF,26,DAL,34,34,1002,229,508,.451,49,173,.283,180,335,.537,.499,147,170,.865,64,197,261,69,25,59,53,88,654
450,Kristaps Porziņģis\porzikr01,PF,26,WAS,11,11,306,74,161,.460,15,50,.300,59,111,.532,.506,72,82,.878,24,66,90,32,9,16,19,36,235
451,Micah Potter\pottemi01,C,23,DET,3,0,31,5,11,.455,0,2,.000,5,9,.556,.455,2,2,1.000,4,5,9,0,1,1,1,4,12
452,Dwight Powell\poweldw01,C,30,DAL,75,64,1613,234,356,.657,13,36,.361,221,320,.691,.676,140,180,.778,159,196,355,89,34,34,55,198,621
453,Myles Powell\powelmy01,PG,24,PHI,11,0,52,5,17,.294,1,6,.167,4,11,.364,.324,2,2,1.000,1,5,6,3,1,0,3,8,13
454,Norman Powell\powelno01,SF-SG,28,TOT,43,41,1413,267,584,.457,99,243,.407,168,341,.493,.542,176,218,.807,20,120,140,94,42,19,67,100,809
454,Norman Powell\powelno01,SF,28,POR,40,39,1333,247,542,.456,93,229,.406,154,313,.492,.542,159,198,.803,17,114,131,82,40,17,62,92,746
454,Norman Powell\powelno01,SG,28,LAC,3,2,80,20,42,.476,6,14,.429,14,28,.500,.548,17,20,.850,3,6,9,12,2,2,5,8,63
455,Joshua Primo\primojo01,SG,19,SAS,43,9,789,83,221,.376,34,114,.298,49,107,.458,.452,33,44,.750,30,68,98,61,17,20,45,65,233
456,Taurean Prince\princta02,PF,27,MIN,64,8,1075,164,359,.457,81,214,.379,83,145,.572,.570,55,72,.764,21,140,161,59,44,22,48,101,464
457,Payton Pritchard\pritcpa01,SG,24,BOS,65,2,898,140,332,.422,87,214,.407,53,118,.449,.553,19,19,1.000,27,91,118,127,20,5,38,55,386
458,Trevelin Queen\queentr01,SG,24,HOU,10,0,74,15,33,.455,9,24,.375,6,9,.667,.591,4,4,1.000,7,9,16,4,5,1,7,6,43
459,Neemias Queta\quetane01,C,22,SAC,11,0,71,10,24,.417,0,0,,10,24,.417,.417,4,7,.571,12,8,20,4,1,4,4,11,24
460,Immanuel Quickley\quickim01,PG,22,NYK,72,2,1611,242,624,.388,121,348,.348,121,276,.438,.485,161,179,.899,27,181,208,227,46,3,90,153,766
461,Jahmi'us Ramsey\ramseja01,SG,20,SAC,19,0,134,24,58,.414,5,18,.278,19,40,.475,.457,7,14,.500,4,9,13,7,1,1,5,10,60
462,Julius Randle\randlju01,PF,27,NYK,71,71,2508,505,1230,.411,116,380,.305,389,850,.458,.458,300,396,.758,125,586,711,363,53,39,242,200,1426
463,Austin Reaves\reaveau01,SG,23,LAL,55,15,1250,126,271,.465,46,145,.317,80,126,.635,.550,68,80,.850,35,124,159,87,25,19,33,80,366
464,Cam Reddish\reddica01,SF,22,TOT,49,7,1012,165,408,.404,66,184,.359,99,224,.442,.485,101,112,.902,25,80,105,48,47,15,57,60,497
464,Cam Reddish\reddica01,SF,22,ATL,34,7,797,138,343,.402,58,153,.379,80,190,.421,.487,72,80,.900,20,64,84,38,35,11,44,45,406
464,Cam Reddish\reddica01,SF,22,NYK,15,0,215,27,65,.415,8,31,.258,19,34,.559,.477,29,32,.906,5,16,21,10,12,4,13,15,91
465,Davon Reed\reedda01,SG,26,DEN,42,5,560,67,138,.486,32,77,.416,35,61,.574,.601,8,10,.800,13,83,96,43,20,6,11,54,174
466,Paul Reed\reedpa01,C,22,PHI,33,2,253,35,73,.479,2,7,.286,33,66,.500,.493,4,10,.400,34,38,72,13,23,13,8,42,76
467,Naz Reid\reidna01,C,22,MIN,71,5,1118,216,436,.495,52,147,.354,164,289,.567,.555,108,142,.761,96,183,279,66,36,66,73,155,592
468,Nick Richards\richani01,C,24,CHO,47,5,356,57,85,.671,0,0,,57,85,.671,.671,30,43,.698,31,51,82,13,9,20,22,49,144
469,Josh Richardson\richajo01,SG,28,TOT,58,6,1422,204,470,.434,87,212,.410,117,258,.453,.527,85,96,.885,40,127,167,98,44,28,56,106,580
469,Josh Richardson\richajo01,SG,28,BOS,44,0,1087,152,343,.443,62,156,.397,90,187,.481,.534,61,71,.859,26,99,125,66,34,23,39,82,427
469,Josh Richardson\richajo01,SG,28,SAS,14,6,335,52,127,.409,25,56,.446,27,71,.380,.508,24,25,.960,14,28,42,32,10,5,17,24,153
470,Austin Rivers\riverau01,SG,29,DEN,61,16,1343,136,325,.418,75,217,.346,61,108,.565,.534,29,40,.725,19,84,103,86,48,6,50,109,376
471,Duncan Robinson\robindu01,SG,27,MIA,73,67,1923,273,686,.398,217,586,.370,56,100,.560,.556,49,58,.845,23,171,194,121,38,13,58,189,812
472,Justin Robinson\robinju01,PG,24,TOT,25,0,304,28,93,.301,18,61,.295,10,32,.313,.398,4,8,.500,4,17,21,32,9,1,17,27,78
472,Justin Robinson\robinju01,PG,24,MIL,17,0,198,18,57,.316,10,37,.270,8,20,.400,.404,2,2,1.000,2,11,13,21,8,0,11,17,48
472,Justin Robinson\robinju01,PG,24,SAC,3,0,15,1,8,.125,0,3,.000,1,5,.200,.125,0,0,,0,1,1,2,0,0,1,2,2
472,Justin Robinson\robinju01,PG,24,DET,5,0,91,9,28,.321,8,21,.381,1,7,.143,.464,2,6,.333,2,5,7,9,1,1,5,8,28
473,Mitchell Robinson\robinmi01,C,23,NYK,69,59,1758,251,329,.763,0,0,,251,329,.763,.763,83,171,.485,282,313,595,36,53,124,58,191,585
474,Jeremiah Robinson-Earl\robinje02,C,21,OKC,45,36,1029,119,297,.401,50,152,.329,69,145,.476,.485,32,44,.727,73,189,262,45,28,15,35,74,320
475,Isaiah Roby\robyis01,PF,23,OKC,38,21,748,127,242,.525,31,70,.443,96,172,.558,.589,62,86,.721,62,111,173,53,30,26,33,91,347
476,Rajon Rondo\rondora01,PG,35,TOT,35,1,635,63,165,.382,26,79,.329,37,86,.430,.461,19,26,.731,14,86,100,146,26,6,64,48,171
476,Rajon Rondo\rondora01,PG,35,LAL,18,0,289,23,71,.324,8,30,.267,15,41,.366,.380,1,2,.500,10,39,49,67,12,5,34,25,55
476,Rajon Rondo\rondora01,PG,35,CLE,17,1,346,40,94,.426,18,49,.367,22,45,.489,.521,18,24,.750,4,47,51,79,14,1,30,23,116
477,Derrick Rose\rosede01,PG,33,NYK,26,4,636,122,274,.445,37,92,.402,85,182,.467,.513,30,31,.968,21,57,78,103,22,12,39,15,311
478,Terrence Ross\rosste01,SG,30,ORL,61,0,1413,216,542,.399,76,256,.297,140,286,.490,.469,108,125,.864,20,136,156,113,28,12,75,67,616
479,Terry Rozier\roziete01,SG,27,CHO,67,67,2275,478,1078,.443,211,552,.382,267,526,.508,.541,138,163,.847,51,238,289,293,85,24,93,111,1305
480,Ricky Rubio\rubiori01,PG,31,CLE,34,8,970,149,411,.363,59,174,.339,90,237,.380,.434,88,103,.854,15,126,141,225,49,7,90,75,445
481,D'Angelo Russell\russeda01,PG,25,MIN,61,61,1949,378,918,.412,167,489,.342,211,429,.492,.503,177,215,.823,24,181,205,433,57,22,154,123,1100
482,Domantas Sabonis\sabondo01,C-PF,25,TOT,62,61,2136,443,773,.573,39,125,.312,404,648,.623,.598,246,332,.741,201,551,752,323,59,27,195,203,1171
482,Domantas Sabonis\sabondo01,C,25,IND,47,46,1632,331,571,.580,35,108,.324,296,463,.639,.610,191,258,.740,155,412,567,236,46,22,143,146,888
482,Domantas Sabonis\sabondo01,PF,25,SAC,15,15,504,112,202,.554,4,17,.235,108,185,.584,.564,55,74,.743,46,139,185,87,13,5,52,57,283
483,Olivier Sarr\sarrol01,C,22,OKC,18,2,304,36,65,.554,6,17,.353,30,48,.625,.600,13,18,.722,23,38,61,13,6,8,16,41,91
484,Tomáš Satoranský\satorto01,SG,30,TOT,47,5,732,57,159,.358,9,45,.200,48,114,.421,.387,37,46,.804,23,74,97,118,27,4,35,56,160
484,Tomáš Satoranský\satorto01,SG,30,NOP,32,3,481,32,107,.299,5,31,.161,27,76,.355,.322,19,25,.760,18,46,64,76,14,1,23,33,88
484,Tomáš Satoranský\satorto01,SG,30,SAS,1,0,9,0,0,,0,0,,0,0,,,3,4,.750,0,1,1,0,0,0,0,0,3
484,Tomáš Satoranský\satorto01,SG,30,WAS,14,2,242,25,52,.481,4,14,.286,21,38,.553,.519,15,17,.882,5,27,32,42,13,3,12,23,69
485,Jordan Schakel\schakjo01,SG,23,WAS,2,0,14,0,6,.000,0,3,.000,0,3,.000,.000,0,0,,2,1,3,0,0,0,0,0,0
486,Admiral Schofield\schofad01,SF,24,ORL,34,1,393,45,104,.433,20,64,.313,25,40,.625,.529,9,12,.750,13,58,71,23,4,5,18,52,119
487,Dennis Schröder\schrode01,SG-PG,28,TOT,64,29,1837,312,724,.431,86,250,.344,226,474,.477,.490,157,184,.853,34,180,214,296,53,8,143,154,867
487,Dennis Schröder\schrode01,SG,28,BOS,49,25,1433,257,584,.440,67,192,.349,190,392,.485,.497,123,145,.848,28,136,164,208,41,5,104,116,704
487,Dennis Schröder\schrode01,PG,28,HOU,15,4,404,55,140,.393,19,58,.328,36,82,.439,.461,34,39,.872,6,44,50,88,12,3,39,38,163
488,Tre Scott\scotttr01,SF,25,CLE,2,0,11,3,6,.500,0,1,.000,3,5,.600,.500,0,0,,1,1,2,0,1,1,0,2,6
489,Jay Scrubb\scrubja01,SG,21,LAC,18,0,121,18,46,.391,6,21,.286,12,25,.480,.457,7,10,.700,2,14,16,8,4,3,7,9,49
490,Wayne Selden\seldewa01,SG,27,NYK,3,0,19,1,4,.250,1,2,.500,0,2,.000,.375,2,4,.500,0,1,1,1,0,0,0,1,5
491,Alperen Şengün\sengual01,C,19,HOU,68,9,1353,228,483,.472,28,106,.264,200,377,.531,.501,154,221,.697,124,235,359,165,58,65,137,200,638
492,Collin Sexton\sextoco01,SG,23,CLE,11,11,316,68,151,.450,11,45,.244,57,106,.538,.487,29,39,.744,13,23,36,23,10,0,31,25,176
493,Landry Shamet\shamela01,SG,24,PHO,62,11,1279,163,417,.391,111,292,.380,52,125,.416,.524,67,80,.838,15,97,112,97,26,7,36,81,504
494,Day'Ron Sharpe\sharpda01,PF,20,BRK,32,8,391,86,149,.577,2,7,.286,84,142,.592,.584,24,41,.585,81,79,160,17,10,15,30,60,198
495,Pascal Siakam\siakapa01,PF,27,TOR,62,62,2335,535,1081,.495,72,197,.365,463,884,.524,.528,255,343,.743,118,398,516,314,76,39,165,210,1397
496,Chris Silva\silvach01,PF,25,TOT,10,0,91,8,15,.533,0,0,,8,15,.533,.533,10,12,.833,13,23,36,7,0,1,8,20,26
496,Chris Silva\silvach01,PF,25,MIN,1,0,3,0,0,,0,0,,0,0,,,0,0,,0,1,1,0,0,0,0,0,0
496,Chris Silva\silvach01,PF,25,MIA,9,0,88,8,15,.533,0,0,,8,15,.533,.533,10,12,.833,13,22,35,7,0,1,8,20,26
497,Marko Simonovic\simonma01,C,22,CHI,9,0,35,4,15,.267,1,5,.200,3,10,.300,.300,8,11,.727,5,5,10,0,1,1,2,6,17
498,Anfernee Simons\simonan01,SG,22,POR,57,30,1681,353,797,.443,179,442,.405,174,355,.490,.555,103,116,.888,26,125,151,221,30,6,115,110,988
499,Jericho Sims\simsje01,PF,23,NYK,35,2,401,28,37,.757,0,0,,28,37,.757,.757,6,18,.333,44,75,119,15,6,14,15,50,62
500,Deividas Sirvydis\sirvyde01,SG,21,DET,3,0,27,1,10,.100,1,7,.143,0,3,.000,.150,0,0,,0,6,6,1,3,1,0,4,3
501,Javonte Smart\smartja01,PG,22,TOT,15,1,164,11,46,.239,4,19,.211,7,27,.259,.283,5,6,.833,4,15,19,14,4,2,9,11,31
501,Javonte Smart\smartja01,PG,22,MIL,13,1,160,11,43,.256,4,18,.222,7,25,.280,.302,5,6,.833,4,15,19,14,4,2,9,11,31
501,Javonte Smart\smartja01,PG,22,MIA,2,0,4,0,3,.000,0,1,.000,0,2,.000,.000,0,0,,0,0,0,0,0,0,0,0,0
502,Marcus Smart\smartma01,PG,27,BOS,65,65,2120,275,657,.419,103,317,.325,172,340,.506,.497,137,173,.792,40,216,256,378,111,17,142,145,790
503,Dennis Smith Jr.\smithde03,PG,24,POR,37,4,638,79,189,.418,6,27,.222,73,162,.451,.434,42,64,.656,20,68,88,132,45,12,51,52,206
504,Ish Smith\smithis01,PG,33,TOT,57,1,939,148,355,.417,21,55,.382,127,300,.423,.446,15,24,.625,25,95,120,193,37,19,64,70,332
504,Ish Smith\smithis01,PG,33,CHO,37,1,511,73,185,.395,10,25,.400,63,160,.394,.422,12,19,.632,11,46,57,98,20,10,36,34,168
504,Ish Smith\smithis01,PG,33,WAS,20,0,428,75,170,.441,11,30,.367,64,140,.457,.474,3,5,.600,14,49,63,95,17,9,28,36,164
505,Jalen Smith\smithja04,PF,21,TOT,47,8,830,154,302,.510,35,104,.337,119,198,.601,.568,71,94,.755,91,189,280,22,12,37,39,84,414
505,Jalen Smith\smithja04,PF,21,PHO,29,4,382,63,137,.460,9,39,.231,54,98,.551,.493,40,52,.769,55,84,139,6,6,18,22,52,175
505,Jalen Smith\smithja04,PF,21,IND,18,4,448,91,165,.552,26,65,.400,65,100,.650,.630,31,42,.738,36,105,141,16,6,19,17,32,239
506,Xavier Sneed\sneedxa01,SF,24,TOT,6,0,28,2,7,.286,1,6,.167,1,1,1.000,.357,0,0,,1,3,4,0,0,0,0,2,5
506,Xavier Sneed\sneedxa01,SF,24,MEM,2,0,8,0,2,.000,0,2,.000,0,0,,.000,0,0,,1,1,2,0,0,0,0,2,0
506,Xavier Sneed\sneedxa01,SF,24,UTA,4,0,20,2,5,.400,1,4,.250,1,1,1.000,.500,0,0,,0,2,2,0,0,0,0,0,5
507,Tony Snell\snellto01,SG,30,TOT,49,12,776,60,153,.392,42,119,.353,18,34,.529,.529,3,3,1.000,15,85,100,25,14,9,18,65,165
507,Tony Snell\snellto01,SG,30,POR,38,10,546,36,97,.371,24,75,.320,12,22,.545,.495,3,3,1.000,11,61,72,20,8,7,11,44,99
507,Tony Snell\snellto01,SG,30,NOP,11,2,230,24,56,.429,18,44,.409,6,12,.500,.589,0,0,,4,24,28,5,6,2,7,21,66
508,Jaden Springer\sprinja01,SG,19,PHI,2,0,6,1,1,1.000,0,0,,1,1,1.000,1.000,0,0,,1,1,2,0,0,2,1,0,2
509,Cassius Stanley\stanlca01,SG,22,DET,9,1,155,19,46,.413,4,17,.235,15,29,.517,.457,10,10,1.000,5,14,19,4,5,2,6,17,52
510,Nik Stauskas\stausni01,SG,28,TOT,8,0,39,5,14,.357,4,10,.400,1,4,.250,.500,4,6,.667,1,2,3,2,0,0,1,1,18
510,Nik Stauskas\stausni01,SG,28,MIA,2,0,24,3,8,.375,2,4,.500,1,4,.250,.500,3,4,.750,1,2,3,1,0,0,0,1,11
510,Nik Stauskas\stausni01,SG,28,BOS,6,0,15,2,6,.333,2,6,.333,0,0,,.500,1,2,.500,0,0,0,1,0,0,1,0,7
511,Lance Stephenson\stephla01,SG-SF,31,TOT,40,1,724,130,289,.450,24,85,.282,106,204,.520,.491,53,67,.791,12,102,114,139,21,3,64,82,337
511,Lance Stephenson\stephla01,SF,31,ATL,6,0,70,5,13,.385,0,3,.000,5,10,.500,.385,1,2,.500,1,14,15,11,0,0,4,8,11
511,Lance Stephenson\stephla01,SG,31,IND,34,1,654,125,276,.453,24,82,.293,101,194,.521,.496,52,65,.800,11,88,99,128,21,3,60,74,326
512,Lamar Stevens\stevela01,PF,24,CLE,56,13,855,131,267,.491,18,56,.321,113,211,.536,.524,40,60,.667,41,93,134,38,28,14,36,91,320
513,Isaiah Stewart\stewais01,C,20,DET,64,64,1662,230,444,.518,6,31,.194,224,413,.542,.525,67,95,.705,204,349,553,68,22,72,80,191,533
514,Max Strus\strusma01,SF,25,MIA,63,11,1456,226,526,.430,163,412,.396,63,114,.553,.585,39,50,.780,24,162,186,86,22,13,51,108,654
515,Jalen Suggs\suggsja01,PG,20,ORL,46,43,1273,194,537,.361,41,190,.216,153,347,.441,.399,126,163,.773,26,142,168,204,56,18,140,139,555
516,Craig Sword\swordcr01,SG,28,WAS,3,0,19,3,4,.750,0,1,.000,3,3,1.000,.750,0,0,,0,0,0,1,4,0,1,7,6
517,Keifer Sykes\sykeske01,PG,28,IND,30,11,552,65,184,.353,26,87,.299,39,97,.402,.424,14,16,.875,8,37,45,60,11,4,33,51,170
518,Jae'Sean Tate\tateja01,SF,26,HOU,72,71,1899,342,677,.505,58,188,.309,284,489,.581,.548,123,174,.707,123,270,393,209,68,40,132,264,865
519,Jayson Tatum\tatumja01,SF,23,BOS,71,71,2569,664,1474,.450,219,616,.356,445,858,.519,.525,376,437,.860,80,493,573,304,67,46,203,164,1923
520,Terry Taylor\taylote01,SG,22,IND,27,3,545,105,165,.636,9,24,.375,96,141,.681,.664,25,37,.676,71,71,142,32,8,6,17,47,244
521,Garrett Temple\templga01,SG,35,NOP,56,16,1059,108,282,.383,56,175,.320,52,107,.486,.482,28,41,.683,29,111,140,73,42,23,40,80,300
522,Emanuel Terry\terryem01,PF,25,PHO,3,0,18,0,5,.000,0,0,,0,5,.000,.000,0,0,,8,7,15,2,1,0,5,4,0
523,Tyrell Terry\terryty01,PG,21,MEM,2,0,3,1,1,1.000,0,0,,1,1,1.000,1.000,0,0,,0,0,0,0,0,0,0,1,2
524,Jon Teske\teskejo01,C,24,MEM,3,0,8,0,1,.000,0,0,,0,1,.000,.000,0,2,.000,0,2,2,1,1,0,0,1,0
525,Daniel Theis\theisda01,C,29,TOT,41,22,820,118,237,.498,28,96,.292,90,141,.638,.557,41,61,.672,46,151,197,34,19,30,42,99,305
525,Daniel Theis\theisda01,C,29,HOU,26,21,584,84,179,.469,23,79,.291,61,100,.610,.534,27,40,.675,32,98,130,20,11,17,31,62,218
525,Daniel Theis\theisda01,C,29,BOS,15,1,236,34,58,.586,5,17,.294,29,41,.707,.629,14,21,.667,14,53,67,14,8,13,11,37,87
526,Brodric Thomas\thomabr01,SG,25,BOS,10,0,48,6,15,.400,1,8,.125,5,7,.714,.433,2,4,.500,2,5,7,8,0,1,4,6,15
527,Cam Thomas\thomaca02,SG,20,BRK,62,2,1120,211,486,.434,45,169,.266,166,317,.524,.480,79,94,.840,16,133,149,76,32,8,51,60,546
528,Isaiah Thomas\thomais02,PG,32,TOT,16,1,269,53,132,.402,21,65,.323,32,67,.478,.481,18,22,.818,3,20,23,29,6,4,12,24,145
528,Isaiah Thomas\thomais02,PG,32,LAL,4,1,101,12,39,.308,5,22,.227,7,17,.412,.372,8,11,.727,1,7,8,6,0,2,5,12,37
528,Isaiah Thomas\thomais02,PG,32,DAL,1,0,13,3,8,.375,0,3,.000,3,5,.600,.375,0,0,,0,0,0,4,0,0,0,0,6
528,Isaiah Thomas\thomais02,PG,32,CHO,11,0,155,38,85,.447,16,40,.400,22,45,.489,.541,10,11,.909,2,13,15,19,6,2,7,12,102
529,Matt Thomas\thomama02,SG,27,CHI,40,0,459,55,134,.410,35,91,.385,20,43,.465,.541,16,20,.800,3,47,50,20,8,3,8,18,161
530,Klay Thompson\thompkl01,SG,31,GSW,28,28,804,199,473,.421,92,245,.376,107,228,.469,.518,39,43,.907,14,98,112,76,16,17,35,43,529
531,Tristan Thompson\thomptr01,PF,30,TOT,50,5,788,123,236,.521,1,3,.333,122,233,.524,.523,56,104,.538,103,151,254,30,22,18,43,88,303
531,Tristan Thompson\thomptr01,PF,30,SAC,30,3,455,76,151,.503,1,1,1.000,75,150,.500,.507,32,60,.533,72,89,161,18,11,12,29,52,185
531,Tristan Thompson\thomptr01,PF,30,IND,4,0,66,13,24,.542,0,0,,13,24,.542,.542,3,8,.375,7,11,18,2,0,2,4,7,29
531,Tristan Thompson\thomptr01,PF,30,CHI,16,2,267,34,61,.557,0,2,.000,34,59,.576,.557,21,36,.583,24,51,75,10,11,4,10,29,89
532,JT Thor\thorjt01,PF,19,CHO,29,0,246,24,54,.444,7,26,.269,17,28,.607,.509,10,16,.625,11,29,40,18,8,10,8,25,65
533,Matisse Thybulle\thybuma01,SG,24,PHI,59,44,1507,136,273,.498,42,133,.316,94,140,.671,.575,34,43,.791,35,102,137,62,101,64,37,145,348
534,Killian Tillie\tilliki02,C,23,MEM,36,3,461,43,127,.339,27,86,.314,16,41,.390,.445,5,8,.625,21,39,60,22,23,15,13,58,118
535,Xavier Tillman Sr.\tillmxa01,PF,23,MEM,48,0,608,86,186,.462,9,40,.225,77,146,.527,.487,40,61,.656,59,88,147,48,45,15,32,57,221
536,Isaiah Todd\toddis01,PF,20,WAS,10,0,41,5,17,.294,4,11,.364,1,6,.167,.412,2,6,.333,2,8,10,3,2,2,1,1,16
537,Obi Toppin\toppiob01,PF,23,NYK,66,5,1030,200,381,.525,33,127,.260,167,254,.657,.568,75,102,.735,63,173,236,62,21,26,49,92,508
538,Juan Toscano-Anderson\toscaju01,SF,28,GSW,70,6,948,110,227,.485,26,84,.310,84,143,.587,.542,40,70,.571,28,142,170,122,46,16,64,107,286
539,Karl-Anthony Towns\townska01,C,26,MIN,69,69,2309,595,1125,.529,139,340,.409,456,785,.581,.591,366,443,.826,179,495,674,254,68,78,211,245,1695
540,Gary Trent Jr.\trentga02,SG,23,TOR,63,62,2195,395,972,.406,185,495,.374,210,477,.440,.502,156,186,.839,24,150,174,130,114,17,65,131,1131
541,P.J. Tucker\tuckepj01,PF,36,MIA,68,67,1905,202,417,.484,79,190,.416,123,227,.542,.579,43,59,.729,96,272,368,142,55,14,64,158,526
542,Rayjon Tucker\tuckera01,SG,24,DEN,3,0,29,1,2,.500,1,2,.500,0,0,,.750,3,4,.750,1,3,4,4,1,0,0,3,6
543,Myles Turner\turnemy01,C,25,IND,42,42,1235,200,393,.509,61,183,.333,139,210,.662,.587,79,105,.752,65,232,297,44,28,118,54,119,540
544,Jonas Valančiūnas\valanjo01,C,29,NOP,69,69,2118,484,897,.540,56,154,.364,428,743,.576,.571,224,273,.821,214,588,802,177,37,59,168,228,1248
545,Denzel Valentine\valende01,SG,28,TOT,24,0,222,25,66,.379,19,47,.404,6,19,.316,.523,0,0,,9,33,42,11,8,0,12,20,69
545,Denzel Valentine\valende01,SG,28,CLE,22,0,204,23,62,.371,18,44,.409,5,18,.278,.516,0,0,,9,29,38,11,7,0,10,17,64
545,Denzel Valentine\valende01,SG,28,UTA,2,0,18,2,4,.500,1,3,.333,1,1,1.000,.625,0,0,,0,4,4,0,1,0,2,3,5
546,Jarred Vanderbilt\vandeja01,PF,22,MIN,68,61,1740,200,339,.590,2,13,.154,198,326,.607,.593,80,122,.656,203,386,589,88,92,42,65,168,482
547,Fred VanVleet\vanvlfr01,PG,27,TOR,61,61,2313,419,1025,.409,229,596,.384,190,429,.443,.520,181,207,.874,43,235,278,407,97,31,158,150,1248
548,Devin Vassell\vassede01,SF,21,SAS,65,26,1750,291,689,.422,118,337,.350,173,352,.491,.508,70,85,.824,41,240,281,120,67,40,53,134,770
549,Gabe Vincent\vincega01,PG,25,MIA,63,26,1503,203,490,.414,111,307,.362,92,183,.503,.528,42,52,.808,22,97,119,200,61,12,94,149,559
550,Nikola Vučević\vucevni01,C,31,CHI,67,67,2242,509,1067,.477,97,308,.315,412,759,.543,.522,86,114,.754,131,626,757,219,67,70,126,169,1201
551,Dean Wade\wadede01,PF,25,CLE,51,28,980,99,217,.456,51,142,.359,48,75,.640,.574,20,30,.667,31,119,150,52,29,7,16,88,269
552,Franz Wagner\wagnefr01,SF,20,ORL,76,76,2391,444,953,.466,93,266,.350,351,687,.511,.515,186,216,.861,83,268,351,227,68,33,118,159,1167
553,Moritz Wagner\wagnemo01,C,24,ORL,57,1,808,169,344,.491,57,174,.328,112,170,.659,.574,93,115,.809,35,153,188,74,17,13,45,106,488
554,Ish Wainright\wainris01,PF,27,PHO,41,0,288,25,73,.342,11,42,.262,14,31,.452,.418,5,10,.500,19,24,43,11,11,6,12,41,66
555,Kemba Walker\walkeke02,PG,31,NYK,37,37,948,149,370,.403,73,199,.367,76,171,.444,.501,60,71,.845,14,97,111,131,26,7,48,37,431
556,Lonnie Walker IV\walkelo01,SG,23,SAS,65,6,1505,292,716,.408,103,325,.317,189,391,.483,.480,106,136,.779,18,147,165,139,39,18,67,94,793
557,M.J. Walker\walkemj01,SG,23,PHO,2,0,8,0,4,.000,0,2,.000,0,2,.000,.000,0,0,,0,1,1,1,2,0,0,1,0
558,Tyrone Wallace\wallaty01,SG,27,NOP,6,0,75,7,20,.350,2,8,.250,5,12,.417,.400,1,5,.200,0,8,8,1,3,1,2,7,17
559,Derrick Walton\waltode01,PG,26,DET,3,3,108,6,26,.231,3,13,.231,3,13,.231,.288,4,4,1.000,2,8,10,21,7,4,11,8,19
560,Brad Wanamaker\wanambr01,PG,32,TOT,23,2,320,28,77,.364,4,17,.235,24,60,.400,.390,23,25,.920,6,33,39,55,7,6,23,45,83
560,Brad Wanamaker\wanambr01,PG,32,IND,22,1,293,26,72,.361,4,17,.235,22,55,.400,.389,20,22,.909,6,29,35,48,5,6,23,42,76
560,Brad Wanamaker\wanambr01,PG,32,WAS,1,1,27,2,5,.400,0,0,,2,5,.400,.400,3,3,1.000,0,4,4,7,2,0,0,3,7
561,Duane Washington Jr.\washidu02,PG,21,IND,42,7,843,148,372,.398,68,186,.366,80,186,.430,.489,38,51,.745,3,68,71,78,21,2,52,61,402
562,P.J. Washington\washipj01,PF,23,CHO,59,22,1588,223,487,.458,105,287,.366,118,200,.590,.566,53,74,.716,77,235,312,132,51,53,73,137,604
563,Yuta Watanabe\watanyu01,SF,27,TOR,35,4,418,54,129,.419,27,74,.365,27,55,.491,.523,21,37,.568,18,66,84,19,8,16,19,37,156
564,Lindy Waters III\waterli01,SG,24,OKC,20,1,356,47,123,.382,35,104,.337,12,19,.632,.524,1,1,1.000,2,52,54,18,14,7,8,26,130
565,Tremont Waters\watertr01,PG,24,TOT,3,0,50,4,14,.286,2,9,.222,2,5,.400,.357,0,0,,0,4,4,7,5,0,4,4,10
565,Tremont Waters\watertr01,PG,24,TOR,2,0,42,3,12,.250,2,9,.222,1,3,.333,.333,0,0,,0,4,4,7,4,0,4,2,8
565,Tremont Waters\watertr01,PG,24,WAS,1,0,8,1,2,.500,0,0,,1,2,.500,.500,0,0,,0,0,0,0,1,0,0,2,2
566,Trendon Watford\watfotr01,SF,21,POR,48,10,869,142,267,.532,9,38,.237,133,229,.581,.549,71,94,.755,57,142,199,81,25,28,44,116,364
567,Paul Watson\watsopa01,SF,27,OKC,9,3,156,12,35,.343,6,26,.231,6,9,.667,.429,1,2,.500,3,24,27,8,3,3,4,10,31
568,Quinndary Weatherspoon\weathqu01,SG,25,GSW,9,0,68,12,20,.600,1,4,.250,11,16,.688,.625,5,5,1.000,2,12,14,4,1,1,3,15,30
569,Russell Westbrook\westbru01,PG,33,LAL,73,73,2513,504,1148,.439,74,250,.296,430,898,.479,.471,243,365,.666,104,443,547,522,73,19,281,217,1325
570,Coby White\whiteco01,PG,21,CHI,55,16,1508,256,583,.439,123,317,.388,133,266,.500,.545,73,85,.859,16,151,167,161,26,11,62,122,708
571,Derrick White\whitede01,SG,27,TOT,69,51,2032,313,754,.415,104,347,.300,209,407,.514,.484,186,213,.873,36,204,240,348,63,57,111,162,916
571,Derrick White\whitede01,SG,27,SAS,49,48,1486,243,570,.426,81,258,.314,162,312,.519,.497,139,160,.869,25,148,173,274,49,42,87,116,706
571,Derrick White\whitede01,SG,27,BOS,20,3,546,70,184,.380,23,89,.258,47,95,.495,.443,47,53,.887,11,56,67,74,14,15,24,46,210
572,Hassan Whiteside\whiteha01,C,32,UTA,60,8,1086,196,302,.649,0,0,,196,302,.649,.649,93,149,.624,147,310,457,22,22,90,51,170,485
573,Joe Wieskamp\wieskjo01,SG,22,SAS,24,0,160,19,50,.380,13,38,.342,6,12,.500,.510,5,9,.556,4,5,9,7,3,3,2,11,56
574,Aaron Wiggins\wiggiaa01,SG,23,OKC,47,32,1125,143,309,.463,40,128,.313,103,181,.569,.528,53,71,.746,50,115,165,60,30,10,47,90,379
575,Andrew Wiggins\wiggian01,SF,26,GSW,68,68,2165,442,952,.464,143,370,.386,299,582,.514,.539,136,213,.638,78,226,304,151,73,48,102,144,1163
576,Lindell Wigginton\wiggili01,PG,23,MIL,16,0,126,16,35,.457,7,17,.412,9,18,.500,.557,11,20,.550,2,15,17,9,3,1,8,9,50
577,Brandon Williams\willibr03,PG,22,POR,18,11,481,86,223,.386,24,84,.286,62,139,.446,.439,57,83,.687,15,43,58,61,19,8,41,40,253
578,Grant Williams\willigr01,PF,23,BOS,71,19,1712,189,395,.478,100,238,.420,89,157,.567,.605,79,87,.908,59,191,250,74,34,51,54,170,557
579,Kenrich Williams\willike04,SF,27,OKC,49,0,1072,146,317,.461,41,121,.339,105,196,.536,.525,30,55,.545,75,145,220,108,44,10,46,81,363
580,Lou Williams\willilo02,PG,35,ATL,53,0,761,122,306,.399,36,98,.367,86,208,.413,.458,62,72,.861,15,69,84,100,28,3,40,48,342
581,Patrick Williams\willipa01,PF,20,CHI,10,5,206,21,43,.488,5,13,.385,16,30,.533,.547,5,9,.556,5,20,25,6,6,3,6,14,52
582,Robert Williams\williro04,C,24,BOS,61,61,1804,271,368,.736,0,1,.000,271,367,.738,.736,65,90,.722,238,350,588,121,56,134,63,137,607
583,Ziaire Williams\willizi02,SF,20,MEM,56,28,1197,164,361,.454,64,208,.308,100,153,.654,.543,29,39,.744,22,93,115,57,30,11,37,103,421
584,D.J. Wilson\wilsodj01,PF,25,TOR,4,1,54,11,15,.733,0,2,.000,11,13,.846,.733,8,10,.800,1,15,16,5,5,1,2,6,30
585,Dylan Windler\windldy01,SF,25,CLE,45,0,408,34,87,.391,21,62,.339,13,25,.520,.511,14,17,.824,19,65,84,29,13,3,14,42,103
586,Justise Winslow\winslju01,SF,25,TOT,48,11,774,110,257,.428,15,66,.227,95,191,.497,.457,39,66,.591,50,152,202,84,35,25,49,67,274
586,Justise Winslow\winslju01,SF,25,LAC,37,1,479,63,141,.447,5,29,.172,58,112,.518,.465,25,41,.610,30,103,133,52,21,18,37,46,156
586,Justise Winslow\winslju01,SF,25,POR,11,10,295,47,116,.405,10,37,.270,37,79,.468,.448,14,25,.560,20,49,69,32,14,7,12,21,118
587,Cassius Winston\winstca01,PG,23,WAS,5,0,27,3,6,.500,2,5,.400,1,1,1.000,.667,2,2,1.000,0,0,0,5,0,0,1,7,10
588,Christian Wood\woodch01,C,26,HOU,68,67,2094,440,878,.501,131,336,.390,309,542,.570,.576,207,332,.623,110,576,686,155,54,65,126,171,1218
589,Robert Woodard II\woodaro01,SF,22,SAC,12,0,42,2,16,.125,1,4,.250,1,12,.083,.156,2,2,1.000,5,6,11,3,1,1,1,3,7
590,Delon Wright\wrighde01,SG,29,ATL,70,8,1302,114,250,.456,40,104,.385,74,146,.507,.536,49,57,.860,45,153,198,167,80,18,44,51,317
591,McKinley Wright IV\wrighmc01,PG,23,MIN,3,0,9,2,3,.667,1,2,.500,1,1,1.000,.833,0,0,,0,0,0,1,0,0,1,1,5
592,Moses Wright\wrighmo01,PF,23,TOT,2,0,4,1,3,.333,0,0,,1,3,.333,.333,1,1,1.000,1,0,1,1,0,0,0,0,3
592,Moses Wright\wrighmo01,PF,23,LAC,1,0,1,0,0,,0,0,,0,0,,,0,0,,0,0,0,1,0,0,0,0,0
592,Moses Wright\wrighmo01,PF,23,DAL,1,0,3,1,3,.333,0,0,,1,3,.333,.333,1,1,1.000,1,0,1,0,0,0,0,0,3
593,Thaddeus Young\youngth01,PF,33,TOT,45,1,708,124,235,.528,12,33,.364,112,202,.554,.553,17,39,.436,68,106,174,88,43,17,48,67,277
593,Thaddeus Young\youngth01,PF,33,SAS,26,1,370,74,128,.578,0,5,.000,74,123,.602,.578,10,22,.455,40,53,93,59,23,7,30,38,158
593,Thaddeus Young\youngth01,PF,33,TOR,19,0,338,50,107,.467,12,28,.429,38,79,.481,.523,7,17,.412,28,53,81,29,20,10,18,29,119
594,Trae Young\youngtr01,PG,23,ATL,69,69,2414,639,1396,.458,208,545,.382,431,851,.506,.532,443,491,.902,45,216,261,665,70,7,276,114,1929
595,Omer Yurtseven\yurtsom01,C,23,MIA,52,11,641,122,227,.537,1,8,.125,121,219,.553,.540,36,57,.632,77,197,274,47,15,19,39,77,281
596,Cody Zeller\zelleco01,C,29,POR,27,0,355,51,90,.567,0,4,.000,51,86,.593,.567,38,49,.776,50,75,125,22,8,6,19,56,140
597,Ivica Zubac\zubaciv01,C,24,LAC,69,69,1683,273,440,.620,0,0,,273,440,.620,.620,153,209,.732,193,385,578,108,35,71,109,182,699